body	social arrived promote conditions talking side wide-ranging central political persuasion since almost however established provide
set	science set in up provide of 1975 means parts research produced weapon is one council
support	research oil instruction some paper avenue conflict there considerations small are knowledge social is science
person	council and combined anthony since with value how a social determine (2 dominant science ‘
paper	the towns do areas giving position values creation health has benefit be indeed ambrose enquiry
one	social set up 1975 promotion means by convened provide occasional views read produced a to
oil	science jobs literature everyone urban ’, welcome dairy today progress jackson seminar creation together 1977
year	research by those convened up 1975 set read views these occasional should and avenue provide
range	council parts conflict right considerations paper now of others instruction set 1 is small three
form	is final parts economic means of in big instruction london (2 set right panel aspects
way	a (2 combined produced social and provide science universities is council schooling means one political
end	body person justified provide research social set informed those public produced to combined one carry
two	set up 1975 by convened views read occasional social should in papers step of promotion
three	up set 1975 by convened views read occasional should papers social step in of research
five	by 1975 up convened set views read occasional should papers social step research in to
audience	royal dividing today and value ideals anthony council claims well-known david since depend paper combined
connection	charter threatened final research temple against may london postgraduate is looking oil some economic debate
cast	for larger schooling promote david alternative health company blue of rationalisations one journal benefit theme
boot	the facts ambrose immigration level be have immigrants on rights fundamental two but do large
there	promotion social set means provide up and produced 1975 one martin north in by combined
large	of in set literature do health ideology up tel established larger jackson one parts more
business	social paper conflict others avenue considerations right value instruction instances boot tel small three research
thing	science universities combined a since martin how council promote values social humane and distinction one
area	research pieces use opinion way being expressed other auspices encourage this take most connection paper
case	its means social are temple is to year avenue set science adopted appropriate social promotion
step	functions make wider a am that (2 may raised way schooling political deserved essentially such
position	are final to oil is research common means a some social avenue instruction 1979 its
point	to social occasional are read set views by 1975 convened up a provide should is
field	encourage research economic prime disseminate final is instruction use wider about council of alternative intensive
people	and council combined since anthony dividing debate promotion a means social research set in how
handle	support grew larger parts conflict quantitatively administration simply fundamental intrinsic clear-cut right large rationalisations vested
sphere	any now ssrc final encourage 1 study economic of often economy sustained make about council
can	means social set promotion parts is instruction and up north a of in oil science
small	in of set one health do established ideology literature up alternative more 1975 provide redundant
uniform	sciences immigration have takes taking air-traffic dispute mercenary choose administrative closest on logically position ambrose
outside	other established one fundamental provide in way produced of pieces expressed research humane more tel
side	person locals ideas its produced provide promote one expressed imputing central informed combined almost correspondingly
outline	or big unusual right sphere final 1979 particular early take to wide is has postgraduate
phase	make besides further final is functions way parts london raised 1979 may about oil characteristic
bracket	grants civilisation 1964 simply think useful members between would concentrated regularly recent tends administration larger
scene	students take familiar priorities which allow observed saunders humane its focussing way sea also wide
background	postgraduate economic priorities final wide dispute aspects right council london instruction 1979 sea are doubtless
information	instruction economic conflict aspects others has means final research oil quantitatively hence is value right
part	carry research is set social means avenue are research a to social of research up
bear	out space dominant distinction dominant in sharp promote is parts commercial of presented sake planning
down	provide produced one established central political literature fundamental promote more wide-ranging side view talking other
date	operate some disruptive meant research has results appropriate upon aspects instruction situation form which ideas
airport	services motivations way opinion instances debate other against types thing life origins pieces depend should
direction	common are wider suburbia oil 1979 publication final make big politicians london way besides series
land	use research under recently intensive take of tel literature disseminate like jackson in work industries
ribbon	carrying distinct high-density it analysis on taking south stress indeed administrative takes air-traffic books likely
collar	on takes have immigration air-traffic administrative south taking ambiguity choose mercenary it distinct arrived ambrose
word	such aspects year appropriate is instruction conflict means journal council sea has too priorities social
pilot	advice should totalled capital-intensive received before purposes felt locals class numbers opposition we race well-known
space	disseminate quantitatively about concerning use of ’. research tel final literature established encourage economic in
base	knowledge paper research others research final quantitatively point of pieces against right council tel should
room	concerning terms centralisation fundamental farms this view accept authors uk promote elicit motivations no instances
scale	1 now london way 1979 final council of parts is characteristic publication economic paper people
court	temple debate not boot instances some its council way with launched servants other pieces value
group	avenue locals social set research up paper oil 1975 claims research is in by and
degree	london way 1 1979 now is final oil wide well-known journal make parts postgraduate economic
building	tel taken this liberty of communities instances in these right use others theme launched other
good	north set means combined promotion jackson social in up of a provide universities those produced
image	sea priorities aspects essentially was much right of economic instruction is alternative observed (2 has
control	oil research instruction final 1979 way are others avenue paper right is london conflict parts
short	panel side in set of up weapon one alternative provide 1975 combined convened should is
house	this expressed concerning tel redundant competition launched origins centralisation published terms pieces instances motivations produced
market	paper social conflict three small considerations research value others council avenue boot oil there instruction
exhibit	one parts 1979 was is london final lend 1 welfare besides make council we like
line	series thing being conflict wider characteristic set most types is predominantly alternative provide research paper
back	produced provide one central political expressed promote wide-ranging fundamental established view persuasion side combined rights
pasture	under use began industries anthropological north near part recently like intensive hoped today take welcome
park	auspices two ’. research pieces motivations competition opinion see published again other this expanding launched
sheep	north anthropological assume multiple another fields under notion older ideology dominant sharp intensive assuming ’,
dinner	sea obvious consideration individuals countryside oil belong bring receive at elicit humane staff amount struggle
coffee	oil countryside conducting together jobs ’, bring workers staff aim word had individuals information everyone
formation	panel final is employment usually manufacturing component parts are recently about special of make avenue
display	was much expert parts right conflict sea quantitatively others may off studies is priorities upon
circle	ssrc study any spokesman often relations rights economy wish focussing high-density inhabited series publication wider
four	1975 up set by convened views read occasional should papers social step in of research
face	promote schooling talking side conditions central unemployment political wide-ranging myth thought social produced combined journal
cake	into aim 529 had who countryside live word struggle everyone cases known close at dairy
material	economic instruction is final aspects are books others parts jackson about of literature of right
hand	political wide-ranging does persuasion promote stand talking central produced definable provide grow myth arrived goals
air	impact literature suburbia work refineries alternative criteria development focussing seminar oil-related time conditions etc side
traffic	scotland being communication types received ’. pattern two thing impact as so determines debate other
crust	oil population are vested run about business also aim effects characteristics nuclear urban seminar answer
earth	developments recently industries rural matters development faith about held etc fertile conditions literature benefit also
scope	now 1 london any council 1979 way wide disseminate value final issue paper economic been
game	its ideas correspondingly locals that direction reputation person imputing answered humane expressed there which rights
structure	final is right big are economic instruction 1979 panel oil aspects of about of london
name	year government determine such appropriate it promote combined in how doing produced martin this disruptive
document	has aspects instruction appropriate the some there economic situation quantitatively conflict cover of research right
shed	sponsored tel category forum larger expanding centralisation papers theme established isolated activities simply society opinion
detail	wide instruction economic final aspects london priorities postgraduate right now students we 1 is familiar
weather	range etc suburbia sane matters impact those nuclear held humane literature placed work public disagreement
pot	enquiries community industry helped bell society aim at number oil refer who countryside dairy workers
bit	universities values science schooling combined promote a since political side (2 one how martin provide
eccentric	institutions (2 dr churchgoing apart observed completed combined numbers was council thus students pilots reports
writing	results aspects observed adopted we appropriate allow instruction values has is economic right the studies
agreement	some research has situation paper there demand boot social are oil not value temple instruction
second	these set social up research ideas fieldwork by 1975 one read science its convened those
print	studies than aspects conflict hamlets was much areas parts off simple today instruction considerations sea
road	being prime wider scotland determines pieces probably so thing role research section provide types opinion
shop	published (see authors instances this motivations expanding division activated other two concerning centralisation so isolated
bus	as types two received mcfarlane capital-intensive denied communication thing opinion scotland external being housing apart
fabric	books immigration engendered ’ ambrose have indeed activities carrying taking air-traffic distinct relating economic activated
expression	journal schooling promote (2 talking far is besides from manufacturing david such impact london essentially
magnet	articles theory false society airport access built 541 relatively aims reason degree raised besides agriculturally
family	in determine expressed this anthony and combined government year social avenue since in research of
post	many instances are polarity there boot that debate opinion well-known other thing engaged argument ‘
office	instances many concerning tel published this opinion no motivations origins other most social services research
heart	however masters oil-related talking social political promote established central schooling conditions provide arrived wide-ranging local
scattering	an development nevertheless location component agriculturally fertile interests public listen special people in refineries very
light	alternative both held focussing side between literature conditions impact health in time etc development established
item	form value instruction values economic others of necessarily vital activated always has upon wide activities
distance	publication 1 relations disseminate wider being london spokesman common ssrc to big politicians scotland impact
open	more fundamental provide established authors in one fieldwork of produced other talking theme view set
letter	appropriate from has adopted year the such disruptive government results aspects argument determine instances important
spoke	it uk government promote seminars determine year produced political schooling wide-ranging central how talking concerning
toilet	medium farms centralisation attributes us agriculturally terms do isolated the crude expediency community shetlander depends
goal	that correspondingly ideas its locals rights imputing cast club doing expressed these meant defend fieldwork
gate	this fundamental incomers base theme same authors see competition centralisation image larger full-time isolated 1965
nine	occasional views read by convened 1975 up papers should set social to research step spokesman
twelve	papers should occasional convened by views read 1975 up set step spokesman social research could
gap	been occupations discussions now 1 disseminate publication 1979 role being paper ssrc depends any debating
church	launched this communities pieces tel way claimed taken other competition opinion auspices research instances expressed
nothing	martin universities science promotion promote combined a determine since year produced such means schooling how
eight	views occasional convened 1975 read by up set papers should social step research to in
home	expressed this produced pieces provide research one humane ideas other opinion in its determine presented
day	those humane research range social provide produced set expressed up 1975 convened one by sane
window	authors fundamental base health theme centralisation concerning terms papers coincided more accept farms established addresses
section	not necessarily essentially temple elicit aspects some vital avenue instruction council has final research economic
page	necessarily not than research the aspects networks vital read occasional form much convened adopted studies
object	of hence final economic aspects instruction sea conflict has big may right considerations is form
tape	the off the bracket predominantly depend do others upon today conflict migration simply economic quantitatively
round	one provide produced established in wide-ranging political promote fundamental central other two side rights more
picture	priorities sea allow few big take aspects students promote postgraduate adopted much schooling essentially right
inside	established other one provide produced fundamental in more do alternative of concerning theme political accept
landscape	take become allow like use students research was priorities recently focussing again another work competition
door	fundamental authors this base more concerning theme centralisation terms provide produced established accept one no
sign	look some different from journal unique such is besides is schooling year promote appropriate alternative
dish	at industry vested belong aim dairy staff who receive into great leisure above everyone niceties
filling	what dairy do everyone known urban who ’, literature had established of staff leisure clearly
mark	meant research that operate ideas spokesman series which one upon read established convened parts occupations
worker	‘ with well-known capital-intensive race since council intensive numbers determine combined anthony correspondingly our locals
city	way pieces research services other against tel so opinion when claimed launched approaches thing motivations
tourist	life services thing scotland (see motivations received pieces ’. impinge them way auspices against follows
parking	’. scotland auspices two disseminate quantitatively expanding pattern being communication external life questions as pilot
drawing	to allow right sphere priorities aspects observed big simple much the results was creation political
bay	end differences bust 1977 finer within again privately work dwellers alterations urban ribbon what run
book	adopted aspects results the appropriate networks observed priorities instruction cover has allow values saunders necessarily
car	two communication capital-intensive explain auspices mcfarlane housing follows as denied types should one provide produced
island	approaches work assuming pieces use way take again research was what against experts like run
belt	(1 currently ambrose immigration suddenness takes males air-traffic on vicinity stress be it have distinct
water	literature seminar oil-related work impact ’, urban etc science section recently together ideology health rural
man	combined since how council promote and dr determine essentially anthony produced science central a universities
employee	with ‘ value council well-known demand social boot anthony temple 1979 our sake instance engaged
farm	intensive use anthropological competition north this today exact under tel jackson thing in fields pieces
opening	fieldwork more ideas these established one up its set in that 1975 fundamental panel of
supply	three jackson paper others literature parts quantitatively science point most oil special social of council
newspaper	areas networks the depend today studies class adopted debate results broader avenue boot necessarily has
manner	(2 schooling a journal combined is promote universities since from essentially final priorities council sea
standing	seminars uk promote produced it provide fundamental concerning one central wide-ranging effectiveness political other since
measure	way london 1979 1 oil parts instruction now characteristic make final may economic is expert
bottom	life provide accept migrants theme about literature arrived side established simply talking fundamental 385 could
swing	stems local where rights planning politicians this living circulation whose involved around am rationalisations discussion
note	from appropriate schooling (2 journal promote universities look priorities has results upon political the such
crest	five effects 2 get vagueness theme interest a south choose vested troublemakers assuming would non-technical
coat	have immigration takes air-traffic taking choose dispute distinct south on it administrative ambrose sorts ambiguity
sun	held both concentrates alternative focussing etc side literature criteria conditions work interests suburbia matters development
ladder	regularly incomers education stress simply larger this modern interest image occupational grew graham role fundamental
woman	since combined how dr determine council promote anthony schooling and essentially sake social side our
map	early aspects instruction final or economic characteristic conflict towns sea much 1 priorities right elicit
overall	1979 way london final oil 1 paper right now economic instruction big parts we research
bride	edinburgh council how determine taking since dr imply assimilated distinct era anthony numbers middle-aged schooling
six	convened by 1975 views up read occasional set papers should social step research in of
lady	dr since how combined determine completed pilots government promote schooling council numbers sake commercial universities
child	anthony era how council determine since combined and lend in distinction our dominant promote professional
food	jackson leisure ideology ’, had aim consideration welcome jobs today bring literature together conducting science
bread	aim who everyone productive leisure problems seen had welcome fields progress ’, into belong niceties
drink	bring conducting together oil countryside ’, general jackson workers information had health literature staff dichotomy
wine	together conducting general oil countryside bring health information ’, had dairy aim known literature staff
butter	everyone jobs progress who aim ’, dairy live differences 1977 known finer had welcome high-risk
cheese	who aim everyone problems seen finer live fields belong high-risk leisure productive known receive had
fruit	had aim close everyone leisure who information ’, welcome live centres jobs clearly known belong
beer	conducting together bring oil ’, countryside general health jackson staff had aim literature information who
cattle	anthropological north fields assume notion today older under dominant intensive leisure ideology hoped actually jackson
soil	recently about literature like developments rural consensus use faith industries development are listen green point
corn	hoped welcome today progress jobs clearly convenient fields had aim scientists part industries ’, science
corner	informed justified theme person centralisation fundamental concerning provide one so authors accept published communities local
barrier	discussions incomers are theme about this been incomer 1978 effects these final run high-density besides
foot	could almost wide-ranging political does persuasion stand goals central provide spokesman phase get arrived produced
bag	be immigration have do attributes politically ambrose number lie aspect nevertheless transportation general touchstone takes
girl	how since combined determine anthony dr era promote schooling distinction side government council talking uk
banner	affected 1971 broader south however it formulated on neighbourhoods enquiry all 1978 perspective divide attributes
symbol	different look sea figures of journal final is london dunrossness such essentially treatment big compare
produce	parts is means of council three economic in was set right instruction conflict point jackson
liquid	seminar literature oil-related information urban science component ’, green special health together development impact known
arm	wide-ranging political persuasion stand almost does arrived central promote prevailing residents phase suddenness talking produced
key	covered aspects instruction final council right up 1979 set may economic 1975 research labour-intensive oil
text	aspects has instruction we economic results such conflict adopted studies sea final right is much
sword	all grew minority understanding wide-ranging political vicinity case officers grow larger persuasion rationalisations stand treatment
event	which ideas locals students its research there answered these form make correspondingly avenue those are
memorial	were anthropologists blue place launched vaguely grounds rhetoric when when communities companies help meant theme
gauge	directly construction thing facilities winds high-density predominantly rationalisations majority stations history perhaps explain simply whom
reign	connected servants claimed appropriate temple research body correspondingly further launched government it determine been there
blood	oil-related literature employment seminar ’, conditions etc usually however special faith impact development talking information
clothing	activities activated others ambrose jackson immigration taking books ’ have position takes dispute facts nevertheless
roof	papers taken goliath theme accept authors same benefit communities larger health rationalisations these tends fundamental
leave	presented expressed other produced is established one provide bears humane more promotion seminars deserved promote
figure	essentially elicit combined promote since not sea social big schooling (2 how useful priorities rhetoric
sea	work literature section run again rural focussing impact ideology about business held another matters etc
flour	progress jobs everyone welcome audience aim ’, who urban niceties known alterations live finer differences
wool	’ sorts position ambiguity have dispute air-traffic immigration takes entire it books taking administrative ambrose
costume	reports taking distinct choose activities air-traffic takes dispute remains have administrative immigration activated engendered myriad
ten	should papers by occasional read convened views 1975 up set step research social panel those
seven	read occasional views convened by 1975 up should set papers social research to step these
gentleman	completed dr combined since pilots numbers race government how attributed determine council correspondingly essentially class
town	pieces way research being opinion expressed launched this other auspices so motivations tel debate against
pile	nevertheless (something be attempts do very major benefit here faith giving why development values activities
ship	felt we opposition purposes should against employed work collar relation two types concentrated received established
walk	deserved one provide types wider uk produced being circulation seminars expressed planning bears prime auspices
path	wider prime being probably politicians theme mentioned section accept incomers effects contrast about what objections
drive	circulation off two capital-intensive explain being follows prime deserved expert the as planning is intrinsic
wedge	because minority are court e.g. grew uniqueness occupations but least so-called oil seen microelectronics giving
remainder	their use considerations some created occasional form views with who characteristic value of operate avenue
wheel	intrinsic lies rights larger wide-ranging two one explain fundamental expect minority rationalisations recent opposition health
hill	interest effects contrast assuming 2 politicians connection being major what section wider absorption experts judge
iron	larger rationalisations above simply do benefit health papers of these ambrose theme literature blue in
plain	audience progress everyone jobs known who air-traffic taking indeed do position ’ takes of taken
river	section connection work literature again perceived sites being sited wider faith role experts first provide
lion	dominant find sharp assume extensive non-technical sense another merchants commercial distinction dominant actually loose each
lamb	ideologies fields receive leisure finer dairy demarcated problems seen who supposed high-risk clearly staff belong
breast	local masters arrived receive 385 answer conditions residents almost persuasion myth definable however defined political
tower	communities down taken papers tel same launched theme liberty anchored statements application authors these origins
scarf	it takes air-traffic distinct entire south have administrative choose ambiguity immigration sorts divide mercenary taking
art	observed allow vaguely when right results well-known economic activated adopted aspects sea students is was
valley	connection section contrast politicians assuming interest again research sites sited effects wider absorption probably being
bend	local planning suddenness stems living residents informed politicians unworthy understanding where females interest nascent arrived
spectacles	communities create side forsythe on term vicinity it air-traffic relates choose immigration peak south taking
rectangle	often spokesman study treatment whom (june useful would ssrc it politically shetland before microelectronics society
cross	cast sited rights that role section incomers assuming one these series provide being wider informed
bridge	role being thing section sited tel this opinion papers rationalisations theory theme debating cast larger
eye	david promote schooling talking alternative unemployment side political wide-ranging along does persuasion industrial social conditions
port	against way felt pieces purposes services thing either together where knowledge considerations small approaches we
ceiling	goliath papers accept theme taken blue benefit health authors farms these crichton focussing creation same
inscription	companies anthropologists vaguely unique rhetoric aspects were space affected few perspective we potential treatment building
umbrella	however choose have aspect 1971 do be affected own wide-ranging distinct all court divide lie
square	spokesman blue taken theme of could economy in often accept big do liberty audience people
student	well-known ‘ observed how anthony with since london determine locals sake debate value correspondingly avenue
shadow	company criteria focussing interests side yet promote concentrates alternative nuclear schooling both held d big
palace	claimed way launched competition origins motivations rhetoric communities this tel pieces activated temple other blue
enclosure	they intend under see this economy competition area incomer industries anchored again encourage same connection
shelter	really category jackson modern theme at quantitatively rural relating papers tends assuming under suggestion polarity
coin	davids merely rights grew case health equal blue vested upon males form minority proportion touchstone
chain	country stress published simply high-density final social avenue rationalisations looking too is analysis one wide-ranging
bank	boot paper value social temple some tel most with use situation instances way avenue conflict
desert	was recently assuming take rural like work become run what another use contrast industries development
foundation	doubtless postgraduate launched knowledge research final these or observed any tel has economy panel instruction
head	central promote wide-ranging produced political definable side arrived provide talking persuasion social unemployment one almost
friend	government determine year it how since combined appropriate promote expressed this uk in dr attributed
shelf	would expediency image isolated vagueness accept modern blue authors theme politicians farms 2 goliath elicit
rock	also rural business surprisingly consensus theme claims separation recently assuming about work matters literature in
doll	claim space reflections era court attributes giving must distinct activated have reports since be dr
wire	simply will rationalisations stress incomers larger false looking do a high-density benefit analysis theme be
crown	servants there temple connected all mercenary ideas considered tradition side only choose answered sustained officers
spring	public sane factors differences finer had 1977 behind great another industries literature belong range business
stomach	masters however talking arrived local established prevailing persuasion wide-ranging social almost conditions 385 oil-related residents
blind	thus since david anthony established distinction how combined sake commercial era dominant council held our
shell	question do are health about benefit rural books conditions answer provision theme ambrose within simply
wave	raised disagreement suburbia experiences alternative besides perceived make literature held interests schooling dispersed work impact
curb	truth oil topic expert is liberty scotland now weapon dichotomy 1979 jackson raised internal situation
rear	lies intrinsic authors fundamental polarity papers two articulate crude established count theme health rationalisations more
flower	behind had competition within at housing another provides shetland public industries enquiries do new society
horn	opposing change health attitudes suburbia answer get depends equal grew above surprisingly do owned (the
band	claims surprisingly also avenue remains locals doing correspondingly royal divides too values sea students prime
vessel	we felt opposition purposes should relation work communication constitute received against count need others employed
angel	concerned myth spreading extensive commercial non-technical seemingly consequence grounds they south promote attributed here base
tooth	here long (the answer airport prevailing constraint change whether minority institution helped fertile enquiries almost
piece	values universities e.g. towns the be benefit do afford activated health into nevertheless at economic
dress	taking air-traffic distinct administrative takes have immigration indeed south dispute sorts choose position ambiguity on
pine	decisions benefit at blue expediency application activated centralisation patterns within close isolated papers chief reputations
tree	at decisions benefit close within industries tends new had provides field varied behind point patterns
glove	level vicinity divide be south the attributes logically international distinct facts immigration takes bearers expediency
narrative	we aspects pahl results final 1979 observed economic priorities (2 allow sea wide simple journal
mouth	talking promote migrants unemployment schooling political prevailing industrial definable arrived side myth conditions wide-ranging does
surface	about are conditions recently literature work rural health alternative employment theme benefit accept business seminar
pull	planning where living around local weapon established one answers involved decisions is provide stems do
horse	actually that distinction said produced one anthropological provide dominant get only national two could another
neck	arrived persuasion wide-ranging talking social side stand central almost promote political does conditions myth definable
cart	national identity camps mcfarlane unskilled actually denied that gives types intrinsic apart opposition aspect housing
drain	who literature depends conflicting us concentration tend statements refer a quantitatively false born centralisation medium
highway	determines being scotland so pattern policed especially prime wider mentioned services effects section contrast role
sole	best 1979 oil covered ambrose value advice lend our use instance people with in some
wild	another assume north work ideology industries assuming dominant commercial behind had distinction actually public sane
title	there servants ideas locals its correspondingly concept which adopted imputing answered instances doing year that
mother	determine how since government anthony era combined dr promote year uk in attributed political expressed
mound	major nevertheless faith sustained interest attempts rural industries topographical politicians defined effects taken encouraged vagueness
check	affect others expert parts dispute established quantitatively studies instruction takes answers oil do was means
wall	theme accept incomers taken fundamental papers authors health blue goliath benefit these base concerning established
watch	bears today one humane doing is attributed established uk presented provide produced promote deserved depend
counter	topic truth published elicit no politically accept is number activated vested others other these country
holder	concept there value with need arc change some council correspondingly unworthy servants boot demand ideas
pool	used intend again literature answered concerning perceived competition work elicit theme industry motivations section faith
cut	weapon provide side one panel in involved of values e.g. planning had benefit science do
canvas	enquiry ambrose towns do be position books creation immigration takes giving the allow have benefit
ad	debates today areas broader having assumption instruction people many expert form 1979 parts value right
finish	defend known creation ideas have that bears obvious audience benefit elicit countryside side decisions is
plate	vested at industry health number community aim staff workers commitment into had business above enquiries
cloud	interests criteria refineries nuclear development etc matters focussing side alternative held rural concentrates impact literature
dressing	community distinct farms taking concerning belong terms ’ position immigration centralisation elicit medium takes attributes
stream	perceived section literature first again seminar oil-related work wider agriculturally faith refineries used etc debating
address	disruptive appropriate year instruction argument operate upon conflict necessarily research from has instances studies the
ivory	change expansion blue contrasted benefit taking ’ health ambrose activated indeed air-traffic position distinct administrative
skeleton	particular or answer are social image question final recent economic larger useful taken conditions employment
wing	articulate lies almost get imputing correspondingly immigrants wide-ranging intrinsic uniqueness that could rights persuasion should
trough	actual sites examine again meaning vagueness goliath us image application middle section would disagreement rural
police	debate opinion race temple and time other expressed capital-intensive pieces two locals research democracy services
link	threatened charter final looking research right scotland conflict is of oil others instruction considerations parts
package	there small conflict hence considerations has right situation paper research instruction some others may social
vein	occasions begin oil-related zone answer welfare we population we journal about analysis employment share economic
museum	when observed vaguely thing way pieces most opinion tel allow services activated instances published other
root	phrase within factors convenient northwards had finer clearly great alterations close oil-rig live belong at
spectacle	familiar students safeguarding was wide priorities take its examples saunders science 1 communities which help
board	engaged upon considerations conflict off locals assumption others research avenue right the felt social predominantly
frame	useful social incomer essentially activated rationalisations afford health big theme larger effectiveness vested politically benefit
portrayal	compare sea different few saunders priorities essentially boom wide we (2 doing students was neighbourhood
male	our sake lend since combined anthony set dominant commercial parts council another in avenue how
ripple	experiences raised both besides interests authority categories socio-economic rose high-density fishermen agricultural processes influences disagreement
table	elicit no effectiveness centralisation essentially concerning accept view fundamental health oil activated authors earnest polarity
train	types as thing opinion received two winds scotland opposition being construction explain communication produced expressed
bill	situation some there has value boot research way with others upon operate paper temple appropriate
lane	probably mentioned being prime wider policed contrast connection total debating so politicians controlled types interest
slump	acquainted involved paper am presumed range living further 1979 science research social truth demands been
aftermath	examples familiar students body exist which appeared connected sea dividing some saunders use attempts meant
dock	where thing against concentrated section incomers end taken opinion forum debating see same felt being
lever	large internal expect immigrants labour-intensive intrinsic does answers before pilot full-time goals explain support the
shape	big final is social right essentially about or side spokesman priorities of alternative in arrived
ice	business matters known health literature rural work faith everyone also about vested development do ’,
marina	impinge contrast life found belonging auspices necessitated motivations would origins (see attachment centre can criterion
beach	what rural judge experts work contrast 2 listen section wider held began interest was accept
edge	justified about theme examine informed wider uniqueness minority wide-ranging person industries 2 accept arrived effects
layer	are about recently conditions employment economic development faith population oil seminar question consensus events rural
steel	rationalisations larger simply do health benefit ambrose but these above papers will taken minority established
brick	taken these theme blue papers tel consensus statements health same communities goliath rural listen benefit
slope	politicians contrast interest effects wider 2 become characteristic recently connection prime assuming would experts away
seed	neglected hoped recently today point welcome high-risk had industries within convenient jobs aim live progress
median	pressure rat usually if 1979 essentially employment characteristic special welfare way not avenue vital oil-related
plumbing	groups newby stations farms quantitatively others demands share medium 1974 activated depends literature three do
drop	involved weapon provide planning general literature where living acquainted am bring do business science health
index	if instruction paper pressure does aspects characteristic quantitatively conflict essentially 1979 economic vital 1 final
street	so being other concerning way pieces scotland theme authors accept published determines base section motivations
furniture	activated activities ambrose benefit farms centralisation no health others isolated position elicit terms vaguely allow
hotel	motivations (see origins concerning services this published instances belonging auspices two opinion terms other pieces
suit	dispute immigration takes have taking air-traffic ’ administrative ambrose choose ambiguity stereotypes sorts distinct springing
dispenser	pits subdivided vested medium having remarks general numerous referent predominantly growth events fishermen wide-ranging application
team	locals ideas its imputing person correspondingly avenue that reputation there doing answered expressed capital-intensive debate
equipment	others conflict considerations may predominantly activities quantitatively instruction demands right expect hence jackson activated point
clock	context 1965 explain communities besides blue intrinsic further between application inclusive predominantly crichton no most
sitting	uk seminars concerning view promote terms it determine produced provide how fundamental one wide-ranging effectiveness
blackboard	whole sentiment inconsistent sphere supposedly shetlanders hub kind occupational ultimately classification treatment outline attachment uniform
design	right conflict others final hence considerations observed small tel during big instruction was aspects council
seashore	ln sentiment collectivities addresses experts danger seem 2 contrast vagueness rationale policed what absorption kind
mountain	assuming interest effects another away also 2 work connection politicians was them become approaches contrast
railway	thing opinion types winds being construction received role as where series scotland tel when sited
station	opinion thing types debate research pieces depend services most instances expressed tel being as motivations
milk	’, everyone jobs aim progress had known who leisure information oil dairy literature staff together
bottle	general together health community conducting bring bell literature industry workers be oil information ’, meaningful
clay	consensus rural faith separation listen applied taken recently merely benefit do blue also health larger
storage	quantitatively off others disseminate considerations instruction three conflict may of hence expert do small science
pair	’? immigration set takes ambrose taking dispute choose myriad air-traffic have do 1975 in of
plastic	do health giving but ambrose rationalisations be the events in above larger of established literature
floor	accept theme centralisation papers concerning fundamental goliath elicit authors benefit view blue health faith farms
guard	democracy race debate numbers case established other capital-intensive time could fundamental promote this distinction lies
block	liberty tel communities taken origins these spokesman rationalisations of accept theme instances larger economy in
sandwich	possible who seen productive belong aim high-risk problems e.g. cases clearly struggle made receive leisure
cabinet	area isolated apart no expediency activated maintain elicit assumption ideals health number ultimately effectiveness farms
computer	conflict considerations small predominantly others demands instruction than off right paper hence may social there
match	ideas its correspondingly direction locals that imputing person there expressed humane answered reputation workers which
panel	assumption much engaged area politically right economy authors locals theme health scene spokesman towns during
terminal	either conflict considerations small looking quantitatively against scene expert off than others opinion was may
sand	rural faith listen development matters consensus judge literature industries recently separation work fertile attempts what
salt	urban jobs privately progress everyone live differences high-risk literature 1977 alterations welcome information ’, finer
bead	orientation contrasted expansion sufficiently high-density relates divide position have access change yet humorously it fishermen
lens	as migration eyes safeguarding health seems crichton often david theory added living may sordid recent
machine	predominantly conflict others small considerations may explain hence politically off right than two the attitudes
motor	follows communication two explain protect others should construction further unskilled most circulation gives predominantly opposition
animal	dominant commercial ideology distinction anthropological jackson another point north actually sake sharp find anthony oil-related
fish	ideology leisure had jackson receive fields aim literature who welcome in belong of commercial staff
armchair	must earnest effectiveness application polarity elicit applies view lie ambrose forge no dichotomous between immigration
adult	lend sake our anthony dominant ideology council well-known avenue far parts in 1979 and of
tongue	industrial talking does goals political unemployment side arrived myth migrants prevailing get conditions wide-ranging central
circular	economy of spokesman in relations blue taken about rationalisations theme papers vested big right established
card	upon off external conflict engaged expert much may considerations than international the the was important
radio	depend today argument opinion areas others looking migration the conflict besides 171 based services networks
television	today depend areas looking saunders bears migration conflict others networks royal argument much the opinion
cycle	further make follows gives context parts communication point besides special final clear-cut recently lend oil
pin	characterised long labour-intensive simply minority on rights answers decisions administration grew carrying all inclusive support
garden	competition shetland centralisation this industries behind intend theme concerning kind activated benefit in intensive other
nose	unemployment talking promote definable does side prevailing migrants thought central arrived goals wide-ranging myth along
grade	welfare rat 1979 london employment make outside usually one begin people 1 pressure dichotomy vital
cat	sharp distinction dominant situated commercial notion side how dominant era north talking since ideology each
dog	distinction sharp actually dominant second how commercial notion era get one anthony side each does
lamp	between win owned alternative seems status semi-skilled forge no crichton aims health held so authors
meat	leisure fields aim problems receive who had ideology everyone jackson ’, welcome ideologies belong supposed
cane	then deluxe jobs scientists aspect all welcome be benefit effectiveness choose enquiry recent decisions ambrose
entrance	see base fundamental servicing accept same other theme this authors papers auspices tel taken debating
antenna	supporting safeguarding 171 pilot aims perhaps widely most treatment inclusive non-technical began classified commodity depend
leg	almost wide-ranging residents persuasion stand 385 arrived kin could does prevailing phase myth political central
skin	conditions side promote about talking social employment arrived myth alternative oil-related industries literature focussing held
row	co-operation vital perhaps rights series too established person 1975 theme taken one in immigrants set
goat	multiple north actually notion assume immediate anthropological distinction ’, dominant find leisure fields far dominant
hole	occupations rights established debating accept unemployment theme rural talking about be been could one spokesman
ankle	kin residents stand 385 almost persuasion arrived phase traditional prevailing wide-ranging goals deal immediate provision
reception	neighbourhood sea concerning (see no motivations obvious instances argument see individuals launched fieldwork origins fundamental
parade	help ideas attempt objections neighbourhoods humane were sciences sea 1971 types so those find demarcated
desk	no elicit fundamental concerning activated effectiveness view expediency earnest terms area farms instances accept political
chalk	separation consensus rural listen sphere development also taken faith fertile benefit 2 wherever business recently
seat	polarity effectiveness earnest fundamental elicit ambrose must view middle lies wide-ranging (1 produced political persuasion
gun	case grew wide-ranging rights all time does political be provide central goals equal stress two
pottery	merely vaguely consensus course health blue enquiries activated allow benefit touching change larger taken during
vegetable	convenient clearly had progress jobs everyone leisure aim receive welcome staff niceties who fields belong
alcohol	dichotomy conducting usually bring together jobs jackson special ’, oil-related literature information urban science oil
telephone	argument depend looking others conflict instruction today no instances tradition 1965 handle appropriate value 171
female	sake our lend since dominant how combined anthony commercial ideology social council well-known set in
stop	is provide one produced two presented established debate humane truth suburbia bears determine universities planning
cheek	myth 385 definable promote talking persuasion political arrived residents does conditions side unemployment thought goals
label	divides claims perspective activities the networks broader sea such surprisingly remains upon year much economic
horizon	wish focussing work about criteria emerges interests held alternative justified both ssrc effects run company
rope	stress analysis simply currently high-density carrying too it arrived be suddenness attributes administration (1 one
ring	tradition sufficiently contrasted simply argument 1965 one (1 taking health fundamental larger expansion politically upon
player	correspondingly ideas its that imputing doing locals answered reputation examination surprisingly only real rights combined
baseline	rat pressure 1979 usually welfare employment special if outside applies component green way dichotomy consideration
policeman	race debate numbers capital-intensive democracy combined since how ‘ attributed completed distinction pilots dr actually
winter	sane public range etc matters suburbia literature work placed industries another impact business recently assuming
night	humane those expressed provide produced other ideas focussing one its sea view concerning range promote
slide	living planning local examine much society involved where politicians do labour-intensive migration us policies health
couple	step set up 1975 convened by should views read occasional since one papers ’? in
bruise	consider socio-economic unworthy yet acknowledged commodity renovations officers conditions came tends likely myth sustained promote
pitch	possibility prime rural ideas its about papers club range effects become rights politicians business accept
crowd	dividing royal and one so debate its disagreement humane schooling promote suburbia spokesman ideas established
missile	districts should others case communication impact council totalled felt most depend predominantly quantitatively demands facilities
bunch	without differences finer bust assimilated 1977 step dwellers another live universities privately factors ’? divide
coach	imputing correspondingly locals ideas real its doing that person capital-intensive reputation two immigrants types only
customer	value with council instruction paper conflict social boot form considerations argument there than some situation
accent	system (2 schooling postgraduate redundant most from dr only government journal completed criteria term reports
fire	time alternative established impact refineries provide literature held debate etc one case status benefit construction
fist	grow political wide-ranging does phase persuasion councils goals stand patterns 385 definable almost all residents
knock	around planning fundamental our decisions 1965 where stems one deserved discover characterised local phase bring
bird	commercial dominant non-technical ideology loose distinction sharp agriculture another spreading although find residence members at
crack	nascent also local theme occupations vagueness rights justified zone planning development larger conditions health talking
sheet	towns the divide enquiry values organs do number politically books takes be attributes cost rationalisations
nut	locked had aim leisure belong everyone vested deliberately word niceties privately original arrived known ideologies
linen	position takes distinct ’ taking indeed have air-traffic divide ambrose immigration administrative logically sorts south
garage	expanding published fundamental isolated two this exact motivations terms ’. auspices centralisation sponsored taken papers
vehicle	communication two mcfarlane follows scotland denied should housing others explain as opposition camps protect types
magazine	networks areas today adopted cover necessarily the depend remote saunders appropriate vital studies observed locals
ear	along unemployment myth does talking wide-ranging political arrived persuasion residents david conditions migrants central definable
cape	yet have distinct it air-traffic choose immigration widely springing taking administrative divide takes added aware
knife	grew minority all rise wide-ranging does commitment case political stand appear even be divide health
vegetation	like recently industries near take point use attempts at was under well rural about another
wind	suburbia etc impact range matters literature development nuclear held criteria provide refineries work side alternative
plant	point others like recently ideology jackson convenient science at neglected had dominant parts literature of
binding	manufacturing usually employment panel journal final besides controlled about parts country is oil economic make
dune	began under judge rural what 2 aims industries increased was contrast recently like effects relates
straw	greenfield part choose industries ambrose benefit giving rural faith development why have do ’ position
basin	sites section again connection meaningful actual industry community us literature recently work farms business applied
wood	benefit decisions at blue rationalisations activated creation health do industries larger papers consensus accept conditions
grain	today hoped welcome jackson leisure science jobs fields ’ anthropological had rural progress neglected ’,
lake	again section work intend literature used run rural connection perceived sites experts take about assuming
hedge	new industries at shetland incomers provides competition behind within benefit 1978 decisions policies contrast tends
grass	industries shetland side rural equally part faith conditions new benefit listen like greenfield hoped literature
rubber	but do ambrose events rationalisations giving larger be benefit ’ on activities facts health enquiry
litter	very why attempts nevertheless giving number fertile faith rural development recently listen industries might jackson
nitrogen	green special component wishes overwhelming seminar usually recently larger literature urban point recollections three dichotomy
beef	fields leisure ideologies receive supposed who seen problems aim finer factors demarcated everyone welcome clearly
dust	development refineries fertile rural interests faith matters criteria attempts etc listen literature alternative suburbia impact
bowl	industry community at staff enquiries health vested workers commitment refer number aim known ’, helped
leaf	within at differences field industries behind live benefit close phrase had conditions factors tends point
canopy	tends own at 1978 papers patterns within sustained criteria focussing decisions industries yet carrying new
rice	welcome progress jobs hoped dairy aim everyone niceties had belong leisure receive clearly high-risk fields
shrub	provides at behind new care complaints industries like within tends assimilated differ had decisions increase
tissue	employment oil-related conditions usually answer about are denoting outside masters panel economic recently special local
bean	lose high-risk staff welcome finer factors less convenient receive fields aim progress live seen had
sugar	jobs progress everyone ’, urban welcome known who distinguishable information live dairy oil had privately
herd	older assume anthropological north notion sense identifiable another under dominant fields find intensive immediate assuming
terrain	become take politicians contrast assuming 2 use was effects wider experts recently range equally like
flat	redundant origins this in concerning terms centralisation about one accept of provide view authors established
bark	field within benefit at true recently industries varied faith had encouraged rural conditions decisions patterns
acid	usually component special urban oil-related literature employment dichotomy green manufacturing seminar recently information panel etc
frost	placed matters criteria etc nuclear interests industries sane range business suburbia increase conditions examined focussing
habitat	near like under recently another commercial ideology take use become dominant intend loose point tends
pineapple	centres had original high-risk information finer live who close everyone problems seen deliberately dairy northwards
banana	deliberately estates close had who comment centres high-risk finer word everyone problems into aim dairy
shade	yet alternative socialising company south side conditions focussing administrative tends air-traffic behind sorts schooling ambiguity
phosphorus	wishes green component special relative recollections overwhelming recently larger seminar cosy urban semi-skilled are usually
mat	go subject attributes position added talk events relevant have south distinct be ’ takes greenfield
mulch	true field like recently attempts permanence competition negotiation encouraged applicability some very industries are well
skiing	away them estimates assuming answered politicians undoubtedly broken sane matters business become life range reputation
periphery	attract while any sites dimensions examine always take are justified attachment experts emerges location about
boat	opposition felt we two for relation production types should communication collar denied work provide produced
rubbish	why might very attempts fertile nevertheless greenfield faith jackson giving rural development listen do the
herb	care high-risk privately finer close live 1977 convenient differences criticised everyone longer comment provides ribbon
bed	view concerning terms proportion produced provide fundamental earnest effectiveness centralisation side elicit accept uk political
aircraft	should totalled advice districts two others felt communication we purposes need explain opposition impact follows
gravel	listen rural faith consensus judge fertile development industries separation taken applied attempts recently benefit matters
photograph	few priorities migration appropriate broader studies the class important allow sea upon authors year how
trail	objections wider prime high-density assuming faith being interests policed examine deserved criteria students d help
covering	people of spokesman are parts do in quantitatively economic these council weapon about established 1
motorcycle	protect follows gives two communication unskilled only mcfarlane denied should readily as that explain them
ski	them away assuming ambrose force politicians answered controllers estimates forsythe myriad aware for expect vicinity
ridge	effects interest contrast assuming politicians vagueness 2 wider five prime theme being applied connection image
swan	spreading commercial (including scale extensive non-technical concerned arrived dispersal although criteria find seemingly willing did
tea	countryside oil together staff bring ’, aim workers conducting individuals into productive obvious everyone had
potato	clearly belong great factors finer seen had welcome who fields aim convenient niceties problems ribbon
tomato	high-risk dairy finer 1977 live who differences northwards privately ribbon alterations everyone longer problems belong
carrier	need should purposes be received society we felt value boot quantitatively concern others mcfarlane totalled
oxygen	special component green overwhelming usually literature oil-related seminar wishes larger dichotomy are recently employment three
meal	consideration individuals sea obvious leisure jackson belong amount aim countryside receive at welcome oil into
cement	wherever these rationalisations taken today benefit development rural urban consensus separation larger blue investment but
crossing	sited cast section role thing connection see being scotland prime pattern research assuming deserved debating
butterfly	although commercial non-technical loose ideology question another considered behind south within sharp discussion rural criticised
weed	well industries encouraged like accompanied negotiation factors matters neglected rural faith interests listen greenfield equally
thread	high-density carrying analysis stress self-control ’ simply distinct it too humorously books indeed air-traffic side
mantle	population oil are objective about run also like south matters business cost question tends interests
device	may others conflict hence predominantly than quantitatively instruction off besides right final economic considerations upon
track	prime being wider probably politicians effects provide thing afford encourage types circulation two so determines
hardware	considerations conflict small others off than demands hence predominantly right quantitatively paper of instruction there
curve	characteristic politicians about series wider 1 three big way 1979 vital early if make essentially
platform	modern would small accept considerations these debating concentrated incomers opinion types kind theme papers application
driver	capital-intensive two as mcfarlane received race since housing combined imputing debate locals circulation explain apart
trick	rather science choose may universities its going expect values always presumed since surprisingly form only
printer	than conflict considerations small studies off may much predominantly others quantitatively upon necessarily does corollary
button	labour-intensive answers ease large on characterised immigration long changes takes politically goals treatment corollary upon
tool	hence considerations conflict may others small right of instruction predominantly there quantitatively aspects has demands
keyboard	does surprisingly 358 conflict too much off bracket far expert than looking predominantly considerations small
screen	much was expert off conflict authors than upon sea aspects corollary politically assumption today migration
tube	a simply depends do conflicting majority whom vested recent rationalisations society facilities health win question
menu	corollary much aspects than labour-intensive consideration (see studies politically far sea understand upon covered conflict
mouse	far journal employment does dominant off lend much each multiple corollary commercial receive expert conflict
graphic	simple conflict right bracket considerations hamlets aspects studies small observed was to much others than
palette	understand subject socialising creation native sphere corollary allow geographical investment convenient take hence yet constraint
copyright	demand some with considerations has value conflict economic temple not council instruction right use there
shore	experts 2 work what section politicians contrast again become emerges being interest effects wider rural
sunlight	both held alternative concentrates criteria etc focussing nuclear literature impact matters interests side so suburbia
ocean	run work again literature oil business rural about was population recently interests assuming judge section
engine	explain two construction follows winds whom predominantly should communication conflicting unskilled internal types others stations
slice	e.g. finer aim who seen problems everyone possible supposed productive receive into leisure high-risk made
cone	microelectronics interests spokesman often do ’ health study characteristic society economy examine objective because none
fog	nuclear criteria interests etc refineries matters suburbia development both placed focussing held alternative range business
exhaust	stations refineries explain depends construction development conflicting whom majority green groups others impact literature seminar
smoke	refineries development interests equal criteria construction nuclear impact stations literature alternative time etc depends suburbia
rain	etc suburbia matters range literature development nuclear held interests criteria oil-related alternative sane provide both
monitor	expert off much was considerations upon conflict quantitatively small oil others parts does truth affect
shoreline	emerges contrast sentiment experts wish what 2 acknowledged judge become vagueness work wider politicians effects
signal	besides make may journal instruction parts depend others context raised oil experiences alternative most agricultural
paint	creation benefit native science do relative conditions allow faith development known the constraint enquiry health
spray	public literature development rural etc seminar events matters refineries do creation interests criteria work urban
radius	relations economy whom publication spokesman ssrc about characteristic recent expected often disseminate deserved further a
shield	officers all vested treatment rationalisations above big vicinity consider incomer useful question recent wide-ranging minority
dial	handle argument looking massive arc planning context depend varied pilot high-density men tradition large still
snow	matters etc business rural development criteria faith nuclear interests suburbia placed literature fertile developments industries
fold	another known progress processes commitment constraint background position jobs privately 529 before business interaction likely
basket	aspect be number then do nevertheless industry elicit meaningful vested workers effectiveness us had ’
container	society enquiries do meaningful politically developed number purposes bell community industry a health giving general
skull	provision answer prevailing almost stand kin arrived unemployment myth phase conditions persuasion question central 385
pole	education recent young incomers simply changes intrinsic stress useful almost regularly could wide-ranging communities grew
glass	health general do together authors community industry literature blue business workers vested rationalisations in theme
van	housing two mcfarlane denied communication capital-intensive frontier as camps explain imputing national apart types follows
sack	transportation be meaningful have lie community bell international attributes immigration stress logically nevertheless do clarification
tank	facilities intend ideology literature conflicting health listen 1974 a construction society explain quantitatively do should
concrete	these taken blue wherever do theme rationalisations benefit papers faith larger tel health listen accept
strand	controlled probably differentiated manufacturing high-density towns carrying false are too side afford simply country conditions
spot	nationally what alternative range informed occupations universities are 2 ideas prime one interest established impact
harness	locally vicinity (1 males facts persuasion before ambrose newby be currently stress 385 1965 on
branch	most opinion research instances pieces series debate published thing boot when at point types way
blanket	cost attributes south it have 1978 immigration themselves divide ambiguity sorts ’ takes air-traffic forge
chair	effectiveness earnest must elicit polarity fundamental view wide-ranging no central persuasion political applies produced accept
electronics	demands conflict others considerations right paper rationalisations social should hence point today activities predominantly science
stick	decisions does do rights but grew minority planning sphere could then provide established creation choose
turf	equally industries shetland faith benefit negotiation matters vagueness rural developments these like judge competition part
column	vital co-operation necessarily not characteristic form spokesman networks if essentially assumption towns theme too recent
log	location time narrow benefit application an varied greenfield characteristic theme meaningful decisions quantitatively spokesman owned
batter	things evidence background problems made everyone staff welcome into deliberately agriculturally belong 529 dairy broad
batch	clear-cut conflict quantitatively support considerations studies today off others further form than expert parts constraining
pencil	sphere whether separation constraint does socialising subject d the creation explicit long minority grew to
pad	subject go sphere constraint towns events but proportion do understand the attributes creation number high-density
one-half	controversy papers camp pressure examine spokesman convened by tends with could green read should overwhelming
numeral	achieving investment differentiated lifestyles sense unworthy safeguarding reluctant classified councils owned constituting davids totally aims
thumb	goals does phase residents definable persuasion industrial political 385 wide-ranging talking unemployment uniform myth stand
pie	struggle close aim who fields problems factors staff receive leisure belong seen supposed dairy finer
lunch	obvious sea individuals consideration countryside oil belong bring who aim receive possible staff seen productive
anchor	can stress administration understanding opposition expect all themselves 1965 relation case however what be intrinsic
gear	expect others large intrinsic two migration explain internal immigration activities be communication gives case choose
chicken	receive fields problems leisure dairy ideologies seen demarcated who finer belong staff aim welcome everyone
cigarette	equal refineries owned none depends talking conducting does oil development divide view political definable interests
arrow	treatment understanding minority does recent uniqueness officers often all sphere labour-intensive think unemployment definable wide-ranging
box	politically be do health society giving above towns industry established predominantly vested number in authors
soldier	numbers race since combined democracy capital-intensive how completed ‘ class dr case only 1971 debate
string	too stress simply 358 high-density ambrose does carrying analysis surprisingly set do the it but
desktop	small conflict considerations predominantly than there hence off right paper explicit cheaper expert quantitatively modern
cabin	count farms concentrated terms crude concerning centralisation latter opposition fundamental origins lies kind category mentality
valve	majority bracket surprisingly apart a conflicting ultimately theory explain stations internal answers classified looking scene
deck	concentrated count accept these authors opposition felt papers rationalisations share fundamental established theme goliath modern
laptop	cheaper explicit conflict small identities does much amount tend considerations either predominantly than largest based
debris	attempts development why faith very rural nevertheless listen fertile matters economic recently interests like literature
toe	uniform does goals facts long so-called almost kin bearers residents prevailing provision persuasion arrived equal
kitchen	centralisation farms concerning terms fundamental accept competition authors isolated elicit activated view application this medium
smile	schooling promote journal talking (2 david political type since alternative side thought from how universities
bicycle	gives two protect identity communication facts denied readily national that follows opposition expect intrinsic actually
fork	rise grew commitment does minority meaningful airport growth number interaction political all goals elicit wide-ranging
camera	migration others today 171 as depend expect much may be crichton the conflict case politically
cupboard	isolated expediency farms centralisation fundamental application activated area terms maintain concerning would subdivided affairs authors
glare	so both alternative held between focussing schooling david win promote agriculturally etc experiences despite for
sewing	arises ’ indeed position bear predominantly appear aspect activated simply high-density engendered activities on merely
pen	whether sphere grounds explicit does goals be political constraint the grew uniform international commitment subject
strip	afford values industries simply are theme health accept prime do carrying rationalisations shetland high-density benefit
torso	luxury social councils defined definable prevailing all 385 promote almost wide-ranging persuasion arrived essentially have
cardboard	giving do the above ambrose but greenfield number nevertheless enquiry politically benefit attributes rationalisations health
cartoon	remote networks afford broader saunders today priorities much few hamlets studies areas simple linked observed
finger	does goals political wide-ranging industrial unemployment talking definable arrived almost stand myth persuasion uniform phase
bulb	win between alternative aims semi-skilled most a so owned health institution seems peak present appeared
fountain	grounds whether blue health competition literature intend again used civilisation kind activated taken these rhetoric
seating	questions activated ’. quantitatively polarity earnest people farms must bracket terms modern neighbourhood concentrated statements
tennis	answered broken reputation correspondingly controllers its going ideas away locals rights used doing them which
bedroom	terms farms concerning centralisation fundamental view origins authors base count activated no isolated uk theme
drawer	expediency isolated lie would farms no terms decisions full-time fundamental number touchstone area centralisation elicit
lift	where planning one provide stems established administration construction produced rationalisations persuasion fundamental larger involved weapon
wrist	stand wide-ranging residents kin persuasion phase political 385 almost arrived suddenness councils does goals definable
forearm	councils stand 385 wide-ranging residents phase persuasion almost grow goals kin does political definable arrived
bone	answer provision employment conditions benefit local about health almost consensus prevailing loose oil-related residents denoting
ball	rights one produced provide almost that be political intrinsic side case occupations does discussion suburbia
blade	minority grew all wide-ranging rationalisations does treatment stand persuasion simply constraint definable political prevailing get
foil	organs above 529 towns at do the giving number (and refer e.g. society evidence numerous
compartment	crude count received lies medium terms society farms coincided concerning a would concentrated fundamental centralisation
cuff	deal kin on takes immigration natives experienced perhaps suddenness bearers councils stand engendered persuasion argue
pump	conflicting a depends facilities explain majority construction internal stations literature who 1974 follows talk intrinsic
tights	myriad turn it takes air-traffic taking ambiguity sorts ambrose entire have springing ’? immigration dispute
plaque	anthropologists were vested place arc vaguely rhetoric course change companies employment when civilisation economy officers
plug	tend scene looking simply most 171 who external does bracket agricultural answers added planning false
pouch	regard be immigration have (1 interaction ambrose international traditional touchstone employment attributes begin distinct lie
mural	viewpoint needed broader blue theme obtain application taken economy vaguely during hamlets sentiment subdivided enquiry
foam	events do but public are health seminar development rural giving subject listen ambrose literature benefit
marker	outside employment usually welfare if rat far besides way journal final hence sphere meant about
meter	influences agricultural 1974 most looking conflicting external 171 experiences newby stations may besides upon passing
cream	known everyone who live jobs ’, dairy progress aim had word high-risk 1977 business urban
breakfast	individuals consideration obvious countryside sea aim oil problems productive leisure belong struggle everyone into bring
ingredient	always form hence threatened show lose are discussions may way rather that is doubtless alterations
wayside	danger happen inconsistent ln civilisation accepted came none differ personality tenure closest wishes act towards
triangle	study often ssrc spokesman 1978 any microelectronics behind treatment on big taken (march d south
bacon	problems seen who finer made leisure aim receive fields supposed high-risk belong great everyone productive
signature	unique has some look year form appropriate companies operate upon aspects disruptive besides results economic
quilt	themselves ever proportion sorts south cost it forge court comparatively attributes here takes administrative air-traffic
bite	our constraint industrial e.g. planning leisure around bring talking does uniform d cases agriculturally possible
kettle	present helped community number oil enquiries industry refer status ’, above meaningful depends workers (and
powder	show progress jobs everyone dairy urban live ’, known shetlander literature development alterations seminar high-risk
coil	false theory simply whom high-density looking too a stress depends most arrived may agricultural permanent
tip	uniqueness does unemployment treatment justified recent minority grew industrial constraint wide-ranging goals about uniform health
painting	allow observed vaguely take priorities to creation activated merely enquiry right results science students values
mast	perhaps supporting phenomenon concentrated simply migrants education rationalisations men growth administration arc said we bureaucratic
carving	even grew vaguely benefit blue application activated when minority larger during merely taken course rhetoric
pew	dichotomous maintain must rationale mentioned quality middle policed supposedly polarity isolated image effectiveness launched meaning
speaker	ideals apart aspects council area royal bracket majority besides we anthony surprisingly such answers value
tin	above larger jobs at do aim who ’, number organs into fields staff rationalisations giving
rag	reflections claim divide attributes ambrose side goals have conditions springing likely ’ faith fertile takes
battalion	attempt numbers help force should democracy debate locals facilities received types felt occupations ‘ neighbourhoods
booklet	cover has networks adopted economic towns aspects appropriate the instruction broader or important studies hence
toothpaste	ways institution shetlander moreover show attributes having socialising revert a community ’, do fishermen 1974
sausage	made problems seen who aim leisure high-risk receive supposed everyone belong finer struggle fields staff
notebook	explicit remarks cheaper conflict small whether considerations sphere international touchstone predominantly distinctions does subject lie
yard	forum competition shetland being centralisation so concerning policed accept fundamental see sponsored mentioned prime intensive
shirt	takes immigration administrative air-traffic taking have sorts it on distinct entire dispute ambiguity divide position
monkey	each distinction find loose sharp commercial non-technical notion traits dominant far era pilots incomer residence
hair	side conditions term promote they scale talking industries have arrived alternative takes central air-traffic unemployment
hat	choose have immigration mercenary air-traffic it taking takes vicinity on dispute distinct greenfield south divide
wording	issue now has aspects are (2 manufacturing wide big of is form there way hamlets
vest	over air-traffic takes sorts have entire immigration administrative ’ dialect indeed springing it taking choose
rein	precisely actually skills said occupational that locally old prevailing stress intrinsic stand concern shetlanders mentioned
tide	disagreement raised suburbia literature work etc criteria held range perceived interests matters rural business dividing
sink	us application literature centralisation helped farms medium community bell depends isolated do agriculturally industry health
tail	get does unemployment side arrived industrial central conditions wide-ranging almost could distinction term social talking
statue	rhetoric blue vaguely when essentially anthropologists allow grounds claimed communities application change even launched were
license	of considerations small there expert conflict of value modern paper some than quantitatively against newby
vase	course when community merely industry bell helped workers enquiries health arc vested none change general
elephant	find dominant merchants assume dominant commercial each change relations sense identifiable another notion actually traits
referee	real imputing correspondingly settlement ideas capital-intensive doing reputation collectivity that race class locals only government
slab	objective blue theme contrast image population taken e.g. relates listen 2 application vagueness accept afford
reflector	aims vision win between crichton began engineers relationships existed men supporting institution characterise distinctions associated
hinge	sordid safeguarding before large as lies share unworthy added least carrying shetlanders identified full-time intrinsic
cap	mercenary choose have it immigration takes air-traffic on entire administrative taking added vicinity ambrose dispute
bulge	processes another suddenness experiences ago 385 associated local oil us criteria here sector interests controlled
cooler	examined criteria experienced referent placed range both seminar impact oil nuclear developed literature developments like
gray	forms closest term happen administrative they scale springing characteristics have ambiguity d history takes militated
envelope	important be international lie divide attributes have giving the upon do towns general takes community
hydrogen	component special overwhelming green usually seminar wishes literature larger urban are panel parts dichotomy economic
chimney	statements taken application communities papers refineries blue same whose theme hub anchored kind image dwellings
mud	faith fertile rural development listen consensus matters literature industries attempts recently business etc benefit equally
apron	logically divide takes seemingly air-traffic administrative springing distinct on position affairs immigration taking interaction choose
dome	sustained same major papers tends application communities blue focussing taken troublemakers theme applied suggestion health
fan	examination doing correspondingly reputation locals imputing ideas answered its that also claims government politically surprisingly
mesh	will simply do rationalisations books humorously larger ambrose high-density relating incomers ’ papers events rural
shoulder	persuasion wide-ranging stand political arrived residents 385 almost phase myth kin goals promote prevailing does
shoe	facts the ambrose act have be activities but uniform taking books do activated added bearers
pocket	touchstone immigration international be have ambrose divide takes added on expediency established lie choose political
bat	discussion rights commercial case sharp answered prestige club controllers dominant stand going grew far although
giraffe	i sense merchants furthermore find assume supersaturation immediate older dominant engineers incomer shared classification anthropological
deer	assume another north sense anthropological older dominant ideology find merchants notion commercial loose non-technical multiple
owl	loose non-technical exact commercial bureaucratic answer each assume although ideology dominant another ideology sharp near
eagle	non-technical loose bureaucratic commercial members exact incomer dominant although assume each level agriculture extensive another
antelope	sense assume furthermore i merchants dominant older anthropological find north socially newby another loose achieving
limb	denoting housing employment almost answer conditions residents prevailing wide-ranging does exists traditional about could perhaps
jaw	prevailing definable talking wide-ranging unemployment persuasion migrants arrived almost myth 385 kin promote goals provision
tunnel	debating being theme occupations thing papers perceived see anchored probably dispersal modern role appeared these
barn	exact loose non-technical intensive bureaucratic terms expanding this tel category part taken appeared policed origins
fur	aware have side ambrose ’ term immigration indeed conditions it air-traffic takes choose position taking
ledge	vagueness sentiment addresses civilisation 2 associated effects examine would theme absorption authors occupational politicians collectivities
abrasion	fact bear placed development are shetlanders question likely books rural afford politicians long denoting employment
cow	notion anthropological ’, identifiable north distinction sharp older assume multiple differences each find immediate actually
rib	perhaps sorts residents kin deal bear answer goals prevailing almost engendered co-operation does economy high-density
switch	answers labour-intensive scene looking planning large theory oil characterised than argument does besides may majority
cliff	2 interest contrast politicians experts vagueness effects assuming what also separation theme rural become wider
kite	bureaucratic non-technical loose exact 1971 members formulated absorption commercial production contained stress south totalled meaningful
gull	ideology loose commercial relatively share developed lend non-technical incomer agriculture articulate relates comparatively things housing
mask	division promote mercenary schooling conditions but choose south health it immigration journal forsythe air-traffic have
calendar	dunrossness different networks corollary further remarks broader disruptive necessarily which doubtless form context engendered early
scaffolding	graham formulated incomers taken papers suggestion deluxe rationalisations simply larger these stress theme organs regularly
truck	mcfarlane communication denied camps two housing unskilled as national capital-intensive outline explain should frontier opposition
crane	outline mcfarlane denied personality unskilled farming camps full-time stress intrinsic relation construction internal types opposition
cabbage	factors great finer i.e. ribbon seen interspersed northwards clearly belong emphasise differences fields 1977 receive
contemplation	given royal we journal 1968 phase allow precisely any vision take none observed ssrc useful
stall	division published oil possible belonging leisure ideology had (see into expanding paper national expediency belong
fence	incomers theme simply this discussions papers wider regularly new larger state graham these incomer education
wallpaper	native creation activated taking 1978 forge books known immigration position takes indeed farms administrative distinct
decoration	during blue right activated vaguely health taken merely sufficiently books benefit economy theme creation allow
brook	first perceived section policed intend again interest literature mentioned incomers geographical chat probably who image
elbow	phase stand goals persuasion residents 385 wide-ranging does kin almost definable councils grow political prevailing
heel	so-called kin uniform but facts grew almost councils ambrose arrived stand could persuasion have rights
baby	era anthony how determine distinction since sharp professional ’, ideology promote view combined social side
lawn	shetland industries competition equally new indeed behind forum listen afford side position intend negotiation accept
sky	focussing held alternative criteria promote work wish interests concentrates conditions both side impact etc matters
urn	touching helped merely stressed community industry bell enquiries quality present workers vested number anthropologists civilisation
toddler	professional era anthony how determine that membership race distinction attributed claim be since court facts
bench	middle hub application polarity elicit sentiment state no experienced effectiveness incomers authors fundamental accept uk
photographer	class correspondingly numbers only imputing areas few ‘ instance employer advice collectivity doing real capital-intensive
lip	migrants talking definable unemployment prevailing myth side promote industrial does political residents central arrived along
restaurant	(see motivations belonging published origins consideration concerning employer sea jackson terms neighbourhood opinion authors centralisation
accountant	instance ‘ class boot with well-known imputing advice harris capital-intensive value government real race locals
leather	ambrose immigration do takes have but enquiry air-traffic dispute taking position sorts indeed (1 activated
heater	1974 status born facilities influences between informants talk conflicting most depends humorously centralisation present first
mirror	crichton health farms authors effectiveness application fundamental between elicit theme goliath activated blue aims no
tag	1964 grants relatively neighbourhoods changes upon meant currently aspect such outside divides expect subject situation
goggles	forsythe commodity it vicinity closest communities choose mercenary have but myriad dispute logically create ambrose
speculator	harris instance degree with before often comes respectability critical south seemed demand acquainted communication council
appliance	newby others most status groups considerations agricultural construction locally may sub-divisions demands looking inclusive changing
garlic	1977 finer differences bust privately alterations high-risk dairy everyone belong live who dwellers aim factors
jar	bell community enquiries general industry word rigs health dairy course workers meaningful conducting together society
bubble	rose seminar literature question experiences rural do public health events depends society agriculturally bell development
movie	saunders doing today students much networks adopted pilots bears also its priorities depend remote migration
curtain	1978 south distinct cost air-traffic taking have criteria takes tends immigration indeed forge native divide
narration	pahl we answers fishermen supposed during neighbours critical placed accompanied geographical simple linked 358 whom
bell	1965 fundamental context this argument tradition authors simply larger 1978 intrinsic seems one labour-intensive papers
hoof	some traits scale skills true supposedly relates minority (the get neighbours definable said existed application
moon	concentrates held both focussing criteria alternative interests despite between nuclear company work temporary minority again
stain	socio-economic consider relative cosy conditions long side creation d have faith interests attributes south oil-related
garment	engendered books air-traffic have administrative sorts takes distinct immigration logically taking on south bear indeed
jacket	immigration takes have air-traffic dispute ambrose sorts administrative taking choose on distinct ambiguity south it
homo	complete willing (i.e. tenure seemed dominant rationale any given find we rat whole lend depended
bow	understanding all treatment specifically on carrying choose immigration arrived stress schooling grew taking takes air-traffic
pipe	depends equal a refineries conflicting do literature present looking stations simply enquiries papers whom who
poster	broader affected hamlets few priorities areas studies having perspective allow remote networks viewpoint debates was
logo	perspective divides broader space affected figures surrendered year surprisingly activities politically engendered much companies upon
rack	ultimately majority between bracket isolated area currently a indicated number would politically do (something simply
apartment	origins redundant terms motivations appeared this concerning (see liberty addresses instances tel communities count farms
briefcase	lie international be expediency none identities attributes important immigration have giving meaningful passing here touchstone
napkin	interaction affairs divide attributes seemingly south logically takes position here it immigration commitment unworthy cost
wallet	international lie divide touchstone be important have ease it immigration takes upon on argue grew
cargo	purposes felt we received should names society totalled against today opposition others relation quantitatively need
cable	looking simply scene argument today internal others agricultural depend depends most tend stress thing varied
brake	internal large looking explain conflicting expect received construction intrinsic females majority could two lies winds
star	doing correspondingly saunders examination imputing locals reputation ideas also bears humane year that its combined
leap	am functions involved stems acquainted living presumed deserved raised where politicians categories planning our rights
rider	only collectivity correspondingly readily actually that capital-intensive protect locals imputing did doing class how ‘
racket	going answered facts coincided broken discussion rights controllers nascent 1968 rather communication rationalisations society intrinsic
stereo	bracket majority surprisingly the simple 171 conflict does inclusive scene expert looking others depend ideals
disk	off quantitatively circulation expert considerations conflict upon the than much small external may predominantly was
slot	external off upon as considerations ’. tend quantitatively looking engaged circulation influences conflict predominantly small
socket	scene tend looking agricultural inclusive most answers bracket may either individual does majority assumption against
mailbox	do remarks changing pilot involves newby talk difficult respectable classification else when largest district imply
pond	intend facilities literature again ideology used competition kind listen shetland work industries taken recently attempts
sleeve	argue divide takes have air-traffic on immigration taking distinct persuasion wide-ranging sorts arrived south yet
cord	analysis stress self-control carrying high-density ambrose immigration it takes simply currently air-traffic have sorts attributes
flap	before added air-traffic have large do on share fundamental immigration unworthy often locally currently ambrose
duct	begin employment welfare usually behaviour occasions concentration regard denoting oil-related 1974 depends rat we actual
rim	examine vagueness justified militated simply added actual intrinsic living theme effects would industry politicians (1
pat	little sentiment schooling moreover constraint responsible urban composed refer around myth depended villages side living
egg	background who problems everyone receive high-risk jobs dairy ’, 1977 finer known differences progress aim
juice	information live had privately dairy everyone jobs ’, high-risk original who alterations together centres differences
hay	part greenfield industries hoped under today welcome leisure benefit ’ attempts jackson exact clearly equally
gram	expected papers gross peak relations depended urban socio-economic overwhelming made applicability should occasional sex read
stocking	bear engendered indeed sorts history ambiguity books arises ’ perhaps ambrose bearers entire air-traffic but
calf	immediate kin 385 identifiable residents ambrose almost multiple councils notion persuasion answer arrived employment conditions
knob	changes labour-intensive relatively full-time answers here mercenary likely farming wide-ranging large plan fundamental support chat
lining	relating books ambrose immigration have are question relevant do organs will towns engendered people on
groove	zone image surprisingly possibility prime occupational nascent big probably justified determines actual vagueness a wider
turkey	demarcated receive fields seen ideologies problems finer leisure dairy (including who supposed factors belong background
hook	administration stress recent simply rights can support be wide-ranging where planning characterised minority larger high-density
shovel	growth meaningful part-time rise rural attachment grew commitment faith support attributes all international outline clarification
thorax	potential problem coincided accepted classified provision defined talk prevailing denoting tends companies refute labour actual
abdomen	problem defined potential prevailing local masters arrived depended 385 stand does get kin definable councils
float	changes young education recent health us planning development administration aspect literature living intend aim are
bumper	identified difficult lies two space sordid placed intrinsic respectability control denied crichton cost articulate dichotomous
brow	thought promote type talking unemployment myth definable schooling arrived does prevailing conditions political side migrants
dash	suggestive general dairy authority information urban live circulation everyone involved conducting assimilated privately show welcome
garbage	might why very development fertile meaningful attempts jackson rural faith society giving reflections greenfield be
tablet	place anthropologists were when usually rhetoric fishermen towns upon grounds society whom subject much meaningful
steam	construction refineries winds explain literature thing development received impact directly science interests conflicting types suburbia
locomotive	winds construction thing types explain camps unskilled facilities directly should communication received mcfarlane internal outline
steeple	down communities same categorise image members seems launched anchored (especially treated sustained see wish questions
raft	production opposition belonging relation for concern females bureaucratic seems dialect whose stress socio-economic 541 supposedly
sofa	earnest must effectiveness view ambrose no polarity elicit activated application terms south forge immigration applies
broom	date isolated lie constraint grew deluxe court attributes matters choose logically fundamental centralisation then females
passenger	received types as thing purposes scotland capital-intensive construction two crude camps communication internal should pattern
shutter	largest clearly full-time constitute image likely before coincided whose talk councils authors as especially context
pillow	proportion court view themselves attributes here formulated myth cost earnest comparatively subject divide relevant wide-ranging
feeder	young changes education ideology administration recent bear aim microelectronics varied debating again belong comment a
vent	professionals 1965 microelectronics examine tends court referent behaviour exists will development likely before totally fertile
sill	associated money vagueness addresses lifestyles supposedly coincided sentiment authors base minority good incomers examine here
conductor	various correspondingly class 358 imputing only saunders government referents doing received race collectivity capital-intensive allow
peel	oil-rig finer northwards centres factors had live differences who information close meaning 1977 clearly progress
exit	servicing see fundamental sited fieldwork scotland base probably wider ideas lies being policed expanding debating
microwave	based (and sub-divisions quantitatively depend others today conflict looking bracket besides inclusive argument at subdivided
comb	airport constraint histories part-time long rise socialising commitment side court does here passing attributes (the
helium	overwhelming component green special seminar wishes literature a semi-skilled whom examined impact behaviour rose urban
lock	immigrants large fundamental imputing full-time this the correspondingly lies planning farms articulate intrinsic established more
guy	pilots combined attributed since how completed dr distinction doing commercial capital-intensive science sharp race saunders
frisbee	engineers characterise (both matter aims 5 cosy created idea apparent broken referent situated considered rights
skirt	air-traffic administrative taking takes immigration have sorts distinct it ambiguity choose dispute indeed on south
baseball	controllers answered reputation mercenary (both having them immigration forsythe apparent ambrose closest broken discussion turn
blouse	administrative takes air-traffic taking immigration distinct south sorts it have on springing indeed dispute entire
soup	staff belong dairy receive seen aim clarification had oil niceties high-risk fields countryside who ’,
sunset	increased alternative focussing held both concentrates fishermen geographical side etc work interests members criteria judge
flag	1971 affected divide it however taking enquiry bureaucratic south own carrying numbers lay seems air-traffic
cube	(march often spokesman background commodity treatment whom study health within assimilated community giving eyes number
intersection	(june often dichotomous added addresses early maintain would been varied ’. mentioned contrast characteristic determines
pavement	total among good listen accept vagueness probably so being theme concerning base wider authors industries
tray	number community meaningful industry vested above at be workers oil health enquiries countryside helped present
knot	inhabited else carrying it on (1 stress analysis high-density unworthy too takes likely understanding ssrc
cornice	dwellings same application goliath statements theme vision examine papers during hub blue likely kind taken
thigh	385 residents myth persuasion stand phase almost kin defined councils goals wide-ranging arrived prevailing traditional
spectator	1968 reputation controllers royal answered examination going churchgoing value determines dividing proportion settlement council of
petal	541 reason housing behind accepted reputations within shetlanders account administrative sufficiently fishermen expansion understanding whose
ivy	increase industries accompanied housing negotiation critical tenure patterns placed within behind carrying contrasted at term
bud	housing denoting behind increase 541 within accepted society had conditions patterns well consensus at uniqueness
cup	workers oil countryside community industry health helped together bring number general staff vested conducting enquiries
wreath	considered assimilated contrasted unworthy helped aspect refute although reluctant end within orientation yet do new
vine	critical increase then at care deluxe within scientists lot behind neglected lose had housing date
waist	suddenness wide-ranging stand persuasion arrived (1 on immigration stress air-traffic traditional definable one defined residents
stadium	necessitated reputation services answered dividing motivations (see classification impinge imputing ideas locals its examination pieces
edging	policies indeed new carrying shetland ever on native justified self-control meaning industries socio-economic living behind
partition	constraining incomers clear-cut whose these count modern discussions men useful society vital would final goliath
roadway	dispersal sentiment mentioned coincided debating image probably share again modern being judge tends policed actual
gutter	concentration basic who 1976 policed vagueness lie statements us born depends begin detailed designed same
fixture	direction ideas its reputation correspondingly that imputing locals humane which dividing workers club there answered
carrot	northwards high-risk finer factors belong ribbon differences 1977 clearly interspersed live great who presence oil-rig
helmet	vicinity choose immigration on mercenary forsythe (1 takes have all definable currently experienced ambrose it
hip	traditional residents persuasion kin stand 385 almost suddenness phase prevailing wide-ranging (1 goals could arrived
umpire	settlement real club race correspondingly class imputing building numbers rights reputation completed 1971 1968 only
pedestrian	pattern scotland determines received ’. merchants thing being sited communication so readily these as image
trunk	varied at field looking wide-ranging provision society must get arrived decisions persuasion conditions benefit within
carton	developed links comment society live composed community deliberately known everyone background generally supposed ’, cases
droppings	topographical fertile development very faith factors major prestige attempts why commercial (the agriculture 529 nevertheless
brush	constraint airport side attributes creation sphere do does minority subject known grew have 529 commitment
palm	patterns does estates political goals myth deluxe 385 grow at tends industries wide-ranging decisions benefit
berry	land reason characterise ever accepted considered public housing unworthy surrendered close had tenure lay plan
cactus	tenure increase access shared socially exigencies care affairs behind industries enquiries deluxe had negotiation lot
pear	exigencies close had live northwards finer centres who applicability reputations oil-rig information estates dairy deliberately
pigeon	agriculture commercial (including residence receive demarcated distinction ideologies niceties topographical non-technical ideology background great actually
mango	original centres live had information revert who longer finer estates everyone progress close high-risk deliberately
hood	added have entire south on mercenary choose takes immigration before it distinct touchstone indeed ambrose
coconut	estates deliberately everyone jobs had progress original who live patterns alterations high-risk aim privately differences
pitcher	(both engineers antagonism community controllers present none meaningful labelled among health matter countryside number composed
splash	authority within experiences yet commitment suggestive health bring socio-economic literature etc planning members live general
candle	owned between equal alternative depends time theme none refineries sphere civilisation held health win choose
cucumber	ribbon dwellers finer differences bust high-risk factors longer privately who belong live seen 1977 interspersed
pepper	privately differences 1977 alterations finer dairy live bust high-risk urban who information everyone ribbon people
bamboo	deluxe then patterns estates greenfield industries at papers simply benefit decisions graham 1978 taken date
spice	chief live information alterations 1977 dairy everyone jobs privately finer word urban high-risk who differences
chef	employer (see class collectivity consideration imply imputing instance pilots belong receive niceties broken settlement generated
rod	recent education whom a administration simply treatment grew rationalisations intrinsic uniqueness incomer get could all
emblem	figures different 1971 contrasted perspective refute rigs considered non-technical shetlanders servants neighbourhoods concerned viewpoint was
groom	council edinburgh readily attributes identity on engendered democracy 171 taking determine transportation lie how denied
pastry	529 evidence into everyone aim who clearly progress word dairy cases receive struggle at applicability
strap	currently (1 stress males unworthy on persuasion immigration arrived analysis suddenness administrative ambrose safeguarding takes
liner	employed felt opposition run we relating be do purposes received society important enquiry airport but
piano	358 surprisingly does too attitudes correspondingly opposing claims allow redundant various the activated 1965 gives
microphone	171 migration most bracket present depend between attributes argument identities the labour-intensive supporting tend agricultural
seam	natives deal books engendered court arises examine afford perhaps locally carrying rationalisations persuasion ambrose argue
color	represents histories yet permanent long councils passing some nuclear experienced cosy big categories fishermen locally
trim	massive ambrose on known stress creation have weapon mercenary suddenness afford do aware in ’
pearl	expansion sufficiently contrasted change indeed peak orientation taking administrative ambiguity distinct on it position totalled
bacillus	labour potential many find indicated rose ln anthropological access employment detailed backdrop ribbon district neighbours
parachute	force them should for behaviour tends case totalled expect attempt rationale level relating bureaucratic vicinity
jet	totalled should advice purposes explain received impact expansion time alternative opposition two change share construction
slit	9 added have exists takes conditions prevailing on air-traffic indeed officers stereotypes treatment 529 administrative
streak	(7 socio-economic so high-density experiences yet schooling (2 treatment criteria scale objections combined fishermen side
cylinder	whom explain recent a do depends first often intrinsic society relations are construction vested false
nozzle	classified safeguarding according referent built majority depends none attachment added relative minority whom deal towns
vane	shetlanders fishermen ’: concern self-control major permanent 541 fact whole they commodity yet owned criteria
tractor	unskilled mcfarlane national two explain camps protect communication winds follows denied outline construction gives added
tungsten	semi-skilled cosy between above win rationalisations larger recollections least are recent overwhelming wishes simply looking
marble	blue taken health benefit application these same theme rhetoric vaguely accept change during consensus spokesman
sail	collar opposition felt work stress types run 1971 we experts females changes concentrated us almost
center	while attract needed boom full-time labelled lifestyles examine any traits achieving zone covered economic processes
pillar	hub middle application applied statements blue taken vagueness theme image objective anchored communities between these
booth	still supposedly addresses this application same coincided no category base expediency policed goliath isolated terms
nail	long here uniform creation characterised goals airport simply labour-intensive does grew socialising sphere facts socio-economic
dirt	fertile faith development relative listen rural matters industries attempts oil-related why developments recently separation topographical
shower	agriculturally farms etc both rural medium community perceived us interests criteria public 1978 alternative construction
toast	productive aim who everyone possible problems countryside seen belong ’, word leisure dairy staff had
battery	most agricultural 171 looking three scene others newby follows win quantitatively may influences society simply
transformer	agricultural most influences scene looking inclusive individual besides 171 newby role theory false tend experiences
barrel	sector taken above does base rise case health made conducting mercenary meaningful depends perhaps bell
tongs	part-time appear growth airport status meaningful refer above long attributes commitment histories (and present characteristics
topping	crofting industry everyone known belong generally clearly aim struggle 1977 differences niceties staff who dairy
silhouette	unusual or big essentially communities often level company lie new focussing application hub concentrates comparatively
bin	tracts be aspect very international meaningful why number countryside society do transportation at effectiveness expediency
diamond	sufficiently expansion contrasted tradition peak taking orientation health change on indeed rationalisations whose during question
dragon	extensive dominant commercial assume get actually non-technical distinction spreading rights time 1971 application carrying dominant
latch	full-time expediency this fundamental immigrants eyes lie largest isolated incomer large commodity goals outline currently
chandelier	farming seems coincided contrasted own none health neighbours 1978 communities poor money outline addresses statements
sauce	dairy high-risk everyone privately differences receive 1977 finer belong welcome live who staff information known
bathroom	farms terms centralisation concerning isolated medium agriculturally application count fundamental activated community authors expediency accept
jam	word comment everyone known who aim live jobs into had oil ’, productive high-risk close
hallway	appeared image origins application concerning base terms mentioned same addresses accept farms policed kind none
beard	term side they scale aware industries happen definable choose get south have unemployment forms on
guitar	surprisingly theory majority 358 bracket claims also does correspondingly attitudes arrived too remains apart the
knee	residents kin stand 385 almost persuasion goals wide-ranging phase traditional myth arrived councils definable political
porch	same application base taken papers blue dwellings communities addresses coincided sustained this see fundamental authors
beet	scientists great factors presence jobs welcome hoped belong lose then emphasise clearly convenient northwards progress
jug	community helped industry enquiries bell health general workers present number vested oil together course meaningful
ramp	occupational image vagueness mentioned interest policed behaviour incomers regularly judge pilot 2 would simply theme
dryer	referent sub-divisions examined classified subdivided moreover engineers press designed matter relations built humorously deal born
lap	example wide-ranging persuasion divide currently one definable suddenness goals residents stand view shift here talking
wheelchair	pilot difficult identity for large ’. added follows supporting kind denied occupational opposition gives medium
pan	refer industry problems at finer enquiries niceties everyone staff background community present above dairy receive
riverbank	collectivities south vagueness mentioned ln experts absorption papers thought again what same wider rationale addresses
dais	supposedly still addresses past kind associated category commodity base south involves papers state permanence arc
gown	distinct taking south takes air-traffic it administrative have divide immigration community position carrying sorts entire
soap	shetlander moreover ways show ’, known aim attributes literature urban at group conducting leisure seminar
sociable	churchgoing resource institutions 1968 (2 nearing little another simple thus responsible council matter away lend
cage	incomer non-technical useful incomers commercial recent larger men isolated full-time rationalisations aspect number provision established
rainbow	geographical villages ideology audience alternative increased both understand native concentrates held authority enquiry carrying fishermen
arch	anchored communities taken theme statements debating same hub blue image papers these economy base sustained
teddy	space out claim attributed distinct reports choose facts bear second engendered increased cases reason plan
beak	members non-technical beliefs unemployment commercial talking get question arrived incomer down treatment does share bureaucratic
lemon	live information differences high-risk finer who everyone privately alterations known longer dairy 1977 close bust
spike	least long because semi-skilled examine varied experienced narrow think behind exists minority absorption grew lies
sculpture	vaguely observed allow merely blue activated rhetoric during when even right theme health course anthropologists
chin	definable prevailing unemployment talking myth central political migrants goals wide-ranging does arrived persuasion side promote
buttocks	defined 385 arrived definable stand suddenness residents prevailing masters persuasion problem talking industrial political wide-ranging
doorway	base fundamental authors same see application terms theme this appeared centralisation concerning accept promote talking
thunderbolt	socially tenure sense talk engineers lifestyles furthermore going money exists experienced supporting challenged identifiable race
bull	identifiable notion immediate older find distinction north actually assume dominant fields multiple that our another
jockey	collectivity only imputing actually correspondingly real answered doing class capital-intensive readily protect advice government employer
wrap	numerous south distinct have position ’ air-traffic organs taking it takes attributes values be planning
athlete	referents undoubtedly imputing correspondingly doing reputation class numbers answered readily only pilot examination locals well-known
stump	narrow experienced location almost designed relatively varied quality least centred hub field grow engineers level
foreground	centre we during 541 run contrasted whose impinge or sentiment ’: take fishermen company examined
glaze	characteristics everyone dairy reputations oil seminar locked rigs known 529 had are according productive arc
tripod	eyes state full-time as attachment sentiment looks seems education traits skills deluxe migration hub specified
knuckle	discover obtain supposed comparatively seen press made interaction own rigs fields defined proportion locality peak
tent	suggestion category be graham centralisation own concerning number immigration formulated stress papers 1978 established sustained
sandal	constituting act happen seemingly bearers air-traffic divide ambrose facts myriad massive currently ambiguity scale on
padding	relevant court proportion books go relating ambrose subject commodity forsythe tends fertile dominant inhabited housing
bucket	meaningful number community society health growth be general refer helped bell literature do enquiries none
brace	villages geographical safeguarding females incomers stand long little councils residents kin ideology lies education room
artwork	hamlets aspects studies engendered simple right organs broader priorities much sea than economic has books
badge	neighbourhoods ease mercenary upon sciences choose through characterise springing affected 1964 it have arc closest
dad	attributed membership determine pilots countryside government sea how bears race distinction terms space era combined
stove	status application 1974 (and between present centralisation refer time informants larger benefit part-time isolated construction
blond	they side term scale happen came panel industries how unemployment conditions have south arrived promote
cafe	belonging (see motivations published origins so centralisation expanding auspices apart individuals concerning terms addresses farms
saddle	said actually currently arrived persuasion stress skills lie on goals be all immigration ambrose vicinity
syrup	distinguishable jobs everyone dairy ’, progress known live had word information aim welcome who into
singlet	dialect administrative sorts over springing takes entire myriad air-traffic taking logically level affairs immigration ’
pea	less lose clearly had according staff camp great at finer niceties who convenient high-risk problems
oven	(and based status centralisation present at organs sub-divisions refer problems construction aim health dairy clearly
gauze	humorously position indeed high-density will development attributes it criteria do administrative between self-control carrying books
affray	difference most determines seemed oil temple council influences charter exists issue numbers boom going members
galley	mentality centralisation count status divide policed concentrated isolated fundamental coincided relation civilisation denied farms opposition
drum	attitudes surprisingly predominantly opposing rights society bracket be 358 politically vested do grow incomer too
dugout	belonging concern females production for private opposition good relation 1976 depended neighbours collectivities down count
rooftop	borders vagueness state absorption addresses middle-aged five kind farms so papers terms sentiment many experiences
radiator	born 1974 sentiment coincided talk construction status conflicting depends attributes who application simply whom think
eyeball	and/or exists peak perhaps added feeling currently experienced simple goals judge sentiment booms challenged housing
apple	close had live struggle who deliberately comment exigencies high-risk aim finer into clearly centres at
soccer	reputation answered correspondingly its locals controllers ideas broken imputing doing examination today real necessitated direction
plaything	(i.e. seemed complete before distinct having accepted detailed tended institution bear hence second difference fishermen
cowboy	having apparent controllers ambrose closest widely choose takes immigration it have air-traffic forsythe springing them
apparel	certain activities engendered amused press ago feeling space facts bear ways myriad boom everywhere account
leash	character involves lay stress unworthy likely attributes distinction so-called analysis (especially interaction arrived safeguarding added
stirrup	skills currently said building act all precisely some self-control sorts state (1 poor eyes status
claw	beliefs members men south does airport minority stress stand treatment wide-ranging traits administration passing large
salad	belong who dairy great 1977 clearly niceties staff receive finer aim high-risk factors welcome seen
merchandise	an today activated activities names jackson others purposes form newby anthropological leisure ’ science value
bedclothes	here attributes divide interaction nevertheless establish proportion themselves it position stand south lie cost definable
limelight	room names old international apart socio-economic ease whether involves villages sphere personality protect willing enquiry
moss	negotiation industries faith increase equally like cost shared shetland rural recently well matters development fertile
ma	membership attributed occupational is professional space pilots presented claim countryside imply 1965 gross arises aware
towel	attributes divide south immigration be takes interaction distinct cost here have it likely administrative logically
shampoo	moreover group shetlander ways side public medium bell agriculturally known institution referent constraint according number
pier	criterion same papers mentioned category vagueness what theme needed image kind this concentrated contrast acknowledged
jeep	denied mcfarlane two apart communication housing as camps opposition frontier national gives outline unskilled explain
stool	applies effectiveness must earnest court number polarity theme no elicit application residents view wide-ranging expediency
timer	inclusive scene bracket quick agricultural may present context characterised subdivided newby based 1974 false supporting
grate	meaning finer oil-rig application e.g. privately differences presence live belong northwards factors 1977 nevertheless chief
barge	relation opposition we felt mcfarlane production purposes camps national concern outline education mentality received for
cockpit	latter count concentrated earnest lies explain polarity received base facilities modern crude centralisation authors totalled
outfield	labelled while (both shift absorption females ever engineers direction and/or example categorise especially correspondingly saw
gravy	clarification staff dairy struggle factors high-risk fields problems aim i.e. seen belong receive known longer
cardigan	ambiguity sorts takes air-traffic immigration it ’ have taking on history entire administrative dispute turn
fireplace	application same farms blue status statements civilisation base centralisation isolated appeared taken us activated meaning
smuggler	comes dichotomy for harris expected dialect numbers difference needed nascent prestige refineries ways applicability camps
gelatin	subdivisions jobs neglected recollections longer component respectability usually urban benefit progress cosy jackson wherever subject
shaker	dimensions relatively attract claim community stressed developed part-time workers vested happen growth urban informants relates
footprint	differentiated controlled achieving respectable collectivities whose manufacturing engendered than has explicit aims clear-cut useful we
mane	scale side term they 1978 happen came self-control south get some have on account it
spatula	looks respectable concern contained eyes none commitment grew giving passing added industry applicability dichotomous society
overhang	respectability mentioned money vagueness absorption would applied major judge effects supposedly shetland neighbours coincided application
grease	relative fertile creation faith science development oil-related refineries socio-economic are conditions rural wishes but everyone
spout	permanence true supposedly south relates absorption narrow neighbours present subject our unemployment consider 2 migrants
duck	residence (including receive demarcated made background supposed commercial problems agriculture ideologies aim ideology seen clearly
pebble	relates judge applied none taken passing listen fishermen objective communities rural minority meaningful 2 civilisation
stack	(something nevertheless statements giving ultimately camps important majority studies bracket often why organs major refineries
tile	investment taken blue application health wherever accept benefit rationalisations these achieving relates consensus us papers
crate	locality general identity meaningful be attachment number community conducting developed none commitment giving society lie
mushroom	according high-risk who finer belong seen made factors dairy receive struggle ribbon staff supposed e.g.
mist	criteria nuclear interests refineries matters development focussing etc both impact held rural concentrates 1978 placed
doorknob	clearly state largest men distant land own seem identity crofters full-time categorise large changes here
cab	apart denied majority area ideals two capital-intensive as camps types national communication international housing fundamental
turbine	first whom construction explain relatively especially importance conflicting intrinsic 1974 outline newby raised rose booms
wagon	camps mcfarlane national winds denied communication unskilled received two identity housing apart gives outline relation
kitten	situated sharp happen indicates responsible land era old distinction cases engineers second side comparatively commercial
goose	(including demarcated residence receive problems ideologies agriculture leisure supposed fields great dairy belong spreading made
noodle	camp lose staff at interspersed chat convenient less niceties clearly amount seen concentrates great dairy
beacon	temporary concentrates owned alternative win so hub bureaucratic supposedly depend besides seems effects between feeling
pane	whose coincided statements authors application councils sufficiently minority policed passing total goliath isolated added stems
steak	supposed fields problems seen receive leisure belong high-risk made finer struggle staff who factors ideologies
spoon	commitment industry rise grew word at vested number jobs workers live known high-risk helped clarification
puppy	second distinction that notion space era north commercial situated sharp dominant booms older identifiable undoubtedly
elf	pass while achieving act bearers constituting beliefs permanence close dominant seems treatment centred concerned anthony
insignia	through characterise deal vicinity neighbourhoods contrasted on neighbours forsythe mercenary change ambrose sciences reports have
pickle	rigs belong else seen bell possible made word high-risk who dwellers aim receive finer problems
manhole	respectable south supersaturation looks themselves individual agricultural differentiated no exists do occupations booms tend crude
chrome	permanent rationalisations do cosy larger ambrose theory health recent benefit afford a arrived simply false
lace	indeed taking air-traffic position administrative takes sorts distinct ambrose immigration on carrying south ’ have
ham	seen problems who finer aim fields receive factors staff clearly belong emphasise great possible high-risk
facade	troublemakers sustained same theme taken tel blue hub major communities 1978 five division this activated
hosiery	amused engendered activities position past bear demands certain facts indeed it wherever arises air-traffic over
alley	policed image probably appeared mentioned determines forum so wider none interest being mentality occupational whose
butt	contained quality looks 171 argue stand commitment meaningful does depends grew definable almost sector bureaucratic
baggage	names purposes received an international gives room ’. expect why mcfarlane types denied camps relation
balcony	addresses vagueness kind authors farms same terms origins supposedly application fundamental appeared sentiment state among
driveway	mentioned image probably wider appeared being policed listen occupational forum see dispersal kind dichotomous so
toaster	press present meaning built rigs discover identity past certain referent (and tend institution gross classified
mattress	court proportion view totally themselves attributes cost relevant engendered ever but added effectiveness earnest have
biscuit	cases aim into possible 529 struggle countryside ’, had deliberately who word close productive e.g.
dough	evidence 529 into aim everyone consensus who had organs word leisure composed progress according cases
handkerchief	divide attributes takes distinct logically it immigration interaction position argue affairs choose taking international air-traffic
cauliflower	i.e. factors emphasise great dairy differences finer struggle receive clarification belong ribbon who seen everyone
daisy	reside arrivals behind whether divide (usually sphere traits considered (march assimilated residence indeed then identity
boulder	applied consensus listen relates formulated effects hub faith also rural business separation vagueness sites total
blooming	gross another expected press act tended expanding provides behind carrying care consider identity attributed socio-economic
hut	category suggestion centralisation really count supposedly theme papers sponsored taken exact same this concerning found
refrigerator	subdivided isolated application lie developed farms relates expediency middle sub-divisions inclusive taken present pits affairs
canoe	for opposition private pilot belonging felt females concern production them facts force estimates relation gives
rung	age 1965 it tradition uk attributed sea government obvious determine collectivity terms attachment redundant fundamental
candy	sex oil-rig self-control ’ northwards possible close crofters known humorously numerous 529 organs sorts into
sponge	according into word aim who generally 529 known struggle live attributes welcome had dairy at
catcher	prestige topographical discussion each incomer gross district dispersed past outline land degree backdrop articles then
garnish	dwellers differences ribbon finer bust 1977 alterations factors great privately dairy high-risk live who everyone
chaff	distant clearly greenfield surrendered oil-rig 529 appear cases resource hoped relevant narrow land press question
leek	interspersed finer factors differences ribbon belong great northwards privately high-risk 1977 emphasise close presence seen
lash	broad grow discover along grew things occupational some fact migrants basic industrial all likely existed
buggy	identity national gives pilot camps locality owned denied clearly court shift that kind formulated press
squash	broken answered reputation information away rights live its controllers niceties 529 dairy centres ’, receive
sweater	sorts ambiguity takes immigration air-traffic entire ’ administrative taking have it history distinct ambrose turn
earphone	identities lie cheaper 171 bracket tend supersaturation lay involves experienced phase agricultural feeling image thought
dinosaur	apart commercial dominant particular institutions find eyes provision ideology saunders point denoting traditional answer near
binder	distinctions explicit enquiries quick aims subject native do character creation dialect but towns cover be
stud	reluctant centred considered on contrasted unworthy labour-intensive vicinity ambrose expansion farming sufficiently peak have achieving
skateboarding	categorise difficult down clearly involves based revert all dialect renovations entire space necessitated answered fertile
burner	informants status generated 1974 (and relatively phenomenon between present depends men go influences estates centred
planter	stressed touching objections grounds anthropologists dimensions vision then distinguishable workers decisions jobs convenient at while
skateboard	difficult categorise something pilot built identified involves gives protect questions accepted concern changing names do
thermostat	talk 1974 go born conflicting sub-divisions farms quantitatively socially identity majority added largest do newby
whirl	categories experiences fishermen neighbours am who placed identity so seemingly objections interests incomer springing passing
sidewalk	among total antagonism addresses men good applied absorption mentioned dispersed seem policed ease (both some
tire	occupational membership engineers broad us males numerous planning our belong recollections unworthy problem is responsible
hamburger	crofters links possible amount leisure supposed aim consideration made cases problems niceties into who clarification
speck	fishermen shetlanders d development relates separation rural sentiment socialising lose nuclear experiences often listen histories
zebra	merchants i furthermore sense find assume dominant pattern sited another sex refute change sorts (usually
dent	presumed responsible acquainted our am unskilled renovations consider traits involved e.g. rather considered been respectability
parsley	differences bust privately finer 1977 live dwellers ribbon alterations everyone dairy high-risk who factors people
pavilion	found category role answered impinge communities opinion sustained this see suggestion tends auspices image same
lantern	seems farming between health communities appeared owned as course image down 1965 eyes equal sustained
lodger	imply undoubtedly edinburgh employer district attributed membership numbers engineers experienced international quality do government referents
jean	all takes immigration arises sorts categorise native reason involves position air-traffic turn deal over arc
skate	something difficult occupational bell pilot constitute largest matter likely links share relation collectivities stems cover
hillside	contrast interest politicians effects 2 absorption connection what become wider experts emerges industries objective assuming
robe	south distinct taking administrative have it takes attributes immigration air-traffic on 1978 cost choose interaction
figurine	when course civilisation inconsistent rhetoric land helped even consensus happen anthropologists grounds old males place
seaweed	encouraged faith well industries rural development listen field attempts benefit had true recently major negotiation
oar	think bearers females boom supersaturation treatment concern minority short does commitment men helped exists designed
awning	own tends farming suggestion it pursued account closest 1978 clearly none south many takes arc
navel	basic concentration local surrendered goals proportion springing designed suggestion myth thought unemployment reflections remarks exists
bridle	old males that involves indicates actually when national situated room said commodity seems minority south
candlestick	arc community course number between anthropologists image depended meaningful contrasted forged owned history supposedly society
necklace	contrasted expansion sufficiently change unworthy orientation taking tradition farming air-traffic refute on peak takes distinct
hanger	attachment eyes locality phase subject growth concern sentiment classified seem formulated specifically males would indicated
droplet	access exigencies tenure orientation likely society number traits articles organs appeared rose criteria overwhelming whole
headband	opportunities refute distinct added air-traffic south carrying ambiguity affairs on administrative sorts taking middle-aged choose
braid	self-control analysis high-density administrative indeed sorts on ambiguity air-traffic scale pursued have carrying stress immigration
antler	(the here airport contrasted answer merely topographical change community opposing some commitment assume specified (usually
buckle	males indicates (1 currently unworthy suddenness old locally ambrose on vicinity all contrasted international self-control
paddle	females private belonging think councils internal for opposition local phase production date estimates specifically grew
clasp	unworthy currently males contrasted stress arrived (1 interaction vicinity immigration refute councils lay minority consider
strawberry	comment word close live known had dairy deliberately complaints everyone developed original centres information ’,
scissors	appear part-time grew simply do arises decisions high-density long minority constraint whether carrying institution sufficiently
notepad	remarks explicit changing do maintain subject small linked basic argument conflict dunrossness migration international having
cyclist	readily only gives undoubtedly did protect pattern collectivity council referents matter capital-intensive race received answered
bikini	apparent administrative takes over myriad it having taking suddenness indeed air-traffic immigration distinct refute controllers
radiance	despite both concentrates alternative held so ever between themselves schooling criteria seems focussing renovations experiences
pasta	niceties belong welcome aim progress who everyone great had staff receive dairy clearly leisure seen
outfit	remains taking dispute distinct takes immigration claims reports engendered locals have surprisingly expect choose sciences
bookshelf	indicated would totally ultimately application seemingly isolated court attachment reason supposedly whose intend earnest lifestyles
lamppost	seem safeguarding involves built experienced centred clearly frontier attachment characterise identity among ln chat state
silencer	backdrop money case relatively hub depends ago neighbours sector explain critical designed talk enquiries tend
sunflower	lot everyone progress convenient jobs science who alterations welcome dairy hoped finer reputations distinguishable original
charger	individual agricultural forsythe account scene respectable (usually that apparent most dialect lay situated between experts
balloon	behaviour but do occupational force seminar recent society begin stress facts impact bureaucratic a for
metro	personality outline thing shift good lie denied life as two occupational mcfarlane exist dichotomous services
paw	traits does goals passing some political district definable councils coincided stand patterns each get unemployment
onion	finer 1977 differences high-risk problems ribbon privately who seen live dwellers factors dairy everyone northwards
trouser	stereotypes takes air-traffic dispute immigration closest ambiguity have administrative taking sorts refute over it position
armband	characterise engineers reason through closest myriad seem 1971 aims neighbourhoods land think socialising it depended
dishwasher	sub-divisions based (and referent talk subdivided newby moreover activated status small changing quantitatively inclusive 1974
lotion	group moreover side shetlander conditions public known seminar show institution long bell events science literature
outdoors	differ provides placed kind neglected sane danger public nearing known accepted supposedly examined enquiries industries
patio	kind addresses competition sentiment farms civilisation accept application appeared centralisation papers theme count intend statements
doughnut	degree possible rationale passing often amount subdivided comment into original but harris antagonism supposed relative
pony	that actually only national old gives second get poor denied distinction north scale protect sharp
jersey	entire sorts takes it turn immigration air-traffic have ’ administrative ambiguity distinct closest taking mercenary
underbelly	exist especially appeared personality men interaction yet win rationale problem 1978 until beliefs share students
melon	applicability had live into ribbon dwellers who 529 close welcome e.g. saw original receive finer
nostril	exists existed and/or peak unemployment supersaturation treatment 9 denoting incomer built think experienced does hub
feather	comparatively themselves indeed proportion side have choose administrative discover south court taking grew pursued on
tine	phenomenon men presence informants perhaps simply subject attachment into numerous organs unskilled rationalisations passing airport
shingle	judge rural listen what relates faith acknowledged began these politicians 2 vagueness contrast run taken
eyelash	histories airport supersaturation peak fishermen part-time boom appear represents level moreover reflections long passing treatment
iodine	recollections cosy special wishes green component semi-skilled seminar science literature larger group moreover show usually
bristle	until airport constraint exigencies treatment rural side attributes simply encouraged sphere characteristics negotiation part-time histories
tulip	(usually behind expansion 1977 refute cosy enquiries individual ease extensive deluxe created change (the although
cork	specified benefit commitment do formulated health number meaningful decisions rationalisations but giving investment subject listen
pancake	5 engineers background who possible giving attributes community known niceties lie pilot commitment belong longer
gusto	years unworthy surrendered revert rather then raised presumed shift unskilled e.g. amount schooling reputations permanence
snout	ago unemployment get does definable examine find industrial certain members prevailing 385 processes actual on
eyebrow	type thought schooling talking migrants david central definable promote commodity goals along unemployment traits side
bouquet	assimilated finer bust considered divide public without provides taking distinct attributes differences receive chief dairy
lapel	ease neighbourhoods labour-intensive international stand myth militated expansion touchstone have it closest air-traffic on stereotypes
hoop	centred men reluctant seem share rights experienced airport helped tends stress contrasted lay reflections administration
surf	dispersed nuclear suburbia criteria raised business interests work matters experts run what disagreement judge etc
utensil	building rationale formulated skills refer private commodity built date helped settlement changes staff permanent accepted
motorcyclist	did readily only received accepted militated protect money spreading frontier outline race characterise denied responsible
earring	peak sufficiently expansion exists south contrasted stress histories feeling carrying communities on yet relates term
signpost	1976 concentration especially treatment acknowledged civilisation belonging relates members currently contrast regularly feeling this sited
ashtray	none equal lifestyles helped lie number relates meaningful industry vested community present health depends course
foreleg	existed exists aims experienced largest some challenged uniform depended born beliefs locality broad engineers narrow
airplane	before should advice count frontier totalled vicinity received harris share force attachment 5 facilities seems
penguin	relations find commercial aware loose referent non-technical change plan concerned favours application when sense sharp
frosting	created nearing engineers relatively renovations privately distinguishable (usually dairy people known everyone surrendered comment developed
roadblock	necessity especially quality importance relates past 1976 looks whole coincided denied debate help numbers treated
wrinkle	renovations ’: consider created account pursued clearly experienced presumed accepted institution categorise definable tenure forsythe
siding	forth modern acknowledged objections indicated supposedly emerges help challenged thing winds expanding experienced booms where
gazelle	furthermore sense merchants i assume selling peak find anthropological least encouraged socially so-called narrow older
cadmium	cosy semi-skilled recollections larger permanent socio-economic above sufficiently seminar consensus engineers (usually rationalisations wishes development
parasol	pursued account it self-control ambiguity refute none administrative choose history south own mercenary comparatively interaction
smokestack	’: shetlanders renovations lot especially needed overwhelming reason account centre state supposedly graham ways newby
easel	consequence enquiry tends centred unskilled whose course allow crichton constraint concerned relatively take creation when
haircut	tended dispute side create closest (especially gross space they that taking expect have long term
brim	establish here divide self-control choose indicates unemployment added minority deal meaningful appeared addresses on yet
blazer	closest immigration springing takes stereotypes have entire turn it air-traffic sorts administrative logically dispute distinct
sock	bearers attributes takes springing facts distinct likely think closest engendered interaction administrative it uniform south
graffito	seemed (i.e. having exclusive difference 9 frontier high-density relationships accepted complete harris type fishermen attachment
sunglasses	create communities choose ambrose immigration vicinity commodity closest forsythe ’? dispute logically on activities air-traffic
burger	links crofters amount developed possible supposed belong receive made problems consideration (see aim else who
teapot	helped community present enquiries workers industry number affairs none course oil meaningful commitment health staff
rug	forge sorts it have air-traffic ’ immigration attributes takes 1978 ever cost ambiguity themselves distinct
almond	reputations live everyone who finer known had jobs progress emphasise aim close into niceties welcome
billboard	having ways broader classification debates institution areas saunders basic seemed remarks pits opportunities external 541
tuft	came scale happen they side (especially part term south consider go aware added applied towards
shrubbery	increased frontier shetland mentioned here maintain accompanied lie new began space policed 2 divide acknowledged
talon	militated examine everywhere image ease commodity did surrendered passing term indicates level opportunities ever detailed
mountainside	absorption image contrast vagueness politicians connection 2 interest rationale appeared become mentioned papers collectivities respectability
plantain	arrivals reside criticised within date engineers oil-rig establish convenient ago extensive space sex under oil
tartan	existing it ambiguity ’ indeed position takes immigration air-traffic entire sorts ambrose administrative taking have
dainty	while indeed administrative problems affairs ever claim aware do 385 seemingly taking sex in at
greenery	accompanied increase well like increased ribbon shetland industries state tends contrast behind absorption attempts focussing
bun	composed into aim productive made developed countryside at control staff dairy 529 e.g. comment who
frond	shared negotiation tenure act safeguarding date increase according patterns estates affected lot relates own interaction
asparagus	saw belong high-risk factors who ribbon northwards differences interspersed problems applicability seen great presence longer
camper	frontier denied housing mcfarlane increased seem middle-aged before built clearly did identity internal expanding attachment
bathtub	forged coincided depended arc changing same detailed formulated kind semi-skilled applicability centres organs generated complaints
urinal	relationships aims farming own medium likely affairs yet semi-skilled account down engineers access (especially pilot
wicket	club rights that ideas settlement locals possibility correspondingly discussion mercenary only almost imputing its this
toothbrush	institution ways shetlander turn industry airport long win appear ambiguity constraint here aims present moreover
pylon	obtain discover viewpoint influences maintain importance increased districts neighbours economy officers society varied liberty born
mantel	civilisation application sentiment vagueness when inconsistent kind grants owned relates grounds blue state anthropologists apparent
moped	shift personality identity example protect thought men only labelled pilot good unskilled developed sentiment gives
beverage	tenuous lifestyles bring jackson ’, demands aim together newby cases oil show countryside enquiries equal
fender	men centred acknowledged phenomenon state clearly incomer beliefs aims think count councils among image unworthy
shopfront	neighbours farming coincided investment activated during through some sustained deluxe categories respectability concern policies hamlets
bookcase	maintain isolated application dichotomous area elicit expediency no effectiveness remarks increased state decisions fundamental would
gazebo	past supposedly amused press expanding mentioned classification treated rationale new needed convenient incomers base concentration
mayonnaise	longer live ribbon high-risk belong differences alterations who everyone dairy privately information finer problems progress
skyscraper	needed viewpoint state supposedly while criterion major origins ’: communities hub sustained past (usually found
silverware	willing characteristics arc activated coincided spreading anthropologists davids merely sufficiently society extensive seem complete characterise
cobble	participate kind south listen actual mentioned whose become liberty least production good these money permanence
prong	chat experienced camp recent full-time changes poor defined prevailing skills kin seem consider dialect first
dessert	generally belong dairy had deliberately jobs known according close into who staff everyone live industry
slipper	act facts constituting position ambrose level change distinct skills indeed choose international create shared currently
asphalt	good total listen these mentioned kind shetland separation associated personality industries belonging fertile identity among
muffin	depended responsible problem arc forged accepted progress level cases expected characterise reason care belonging consider
lipstick	socialising yet sphere myriad divide creation airport long side show talking taking understand it constraint
menagerie	favours linked relations degree neighbours remote theory remarks relationships dispersal everywhere relates society assimilated passing
flop	exclusive seemed full-time shetlander club springing acquainted only dispersed force classification help remains actually authority
smudge	d sphere fishermen socio-economic focussing company development relates administrative fertile socialising our characteristics often contrast
headlight	vision aims dwellings denied locally dialect press stressed officers importance men between quick become collectivities
skylight	coincided authors whose forged farming same born state papers application crichton base this formulated vagueness
sweatshirt	turn takes entire immigration sorts it myriad ambiguity closest refute south distinct air-traffic administrative have
runt	land happen when clearly responsible situated concern accepted luxury councils money pilots migrants plan south
pizza	amount belong aim niceties struggle who receive links consideration seen problems leisure fields supposed clearly
fingernail	passing does supersaturation goals traits lie share relates minority long airport seemingly degree international 1978
brassiere	indicates males administrative refute (1 (especially situated bearers establish lay old objections myriad deal immigration
bandage	likely attributes carrying takes distinct bearers sorts divide south councils stress vicinity logically seemingly springing
stairway	image mentioned appeared occupational absorption would policed this objective base contrast effects same taken application
raincoat	springing administrative have immigration closest dispute distinct takes logically air-traffic choose ambiguity south it sorts
rotter	everywhere militated northwards criterion certain ago membership assimilated accepted matter dunrossness reason favours difference those
hovel	detailed coincided forged when concentration traits press category militated bearers fishermen reflections impinge engendered vagueness
tattoo	district traits reason accepted whose amount problem civilisation incomer exists bearers attitudes imply each basic
snowflake	plan south changes space specifically contrasted clearly land (usually absorption peak sufficiently aims linked relations
headboard	totally experienced court themselves helped isolated application treatment indicated maintain bear decisions addresses benefit anthropologists
raisin	control had live amount longer clearly composed niceties estates seen lose welcome reputations belong deliberately
shoelace	else rigs inhabited stress carrying links ever (1 on likely air-traffic distinct analysis full-time amount
tabletop	inconsistent civilisation when whole accepted danger image defined growth coincided eyes associated hub equal press
bedspread	ever themselves administrative attributes south forge air-traffic engendered it sorts distinct indeed cost on court
wristwatch	changing remarks interaction forged passing international seemingly explicit do newby self-control lay thought classification history
fuselage	share lifestyles passing none concentrated before coincided supersaturation goals especially centred members count totalled almost
railing	state experienced clearly coincided eyes incomers men application addresses middle this sentiment relates quality must
eyelid	supersaturation passing respectable migrants histories think exists share defined definable prevailing talking does relates identities
handlebar	nearing created internal forsythe differ institution they term only migrants churchgoing gives unworthy relations controllers
cracker	those people matter identified perhaps seem at whom rigs expediency division peak greenfield pilots too
chump	responsible presumed depended money situated unskilled land mcfarlane seemingly numerous little each growth ideologies resource
tablecloth	affairs interaction divide logically it position helped isolated takes 1978 distinct here opportunities attributes industry
parka	widely south yet turn it ambiguity takes added safeguarding immigration refute ’ choose springing have
breakwater	acknowledged men especially judge consider emerges taken increased what 1976 communities image criterion 2 theme
tarpaulin	formulated applied giving graham proportion coincided specified enquiry likely suggestion stress 1978 building attributes organs
kayak	private for females belonging opposition building work pilot us earnest affairs production relates ever fishermen
blackberry	complaints comment word provides lot close at known another generally characteristics then according distinguishable struggle
coaster	constitute largest we concern matter felt something beliefs clearly for looks mcfarlane difficult likely growth
hayfield	rationale building dichotomous degree absorption policed collectivities owned logically passing force past determines addresses concern
monocle	feeling (especially peak vicinity experienced and/or communities booms lay likely certain account seems said supposedly
footfall	reason 541 characterise land matter springing sentiment district poor attributes indicated entire court space linked
swimsuit	refute turn it opportunities air-traffic taking distinct sorts entire stereotypes takes indicates immigration myriad administrative
skier	undoubtedly away readily referents imply them widely correspondingly only second newby females class collectivity broken
windowsill	sentiment vagueness civilisation born kind accept lifestyles middle dispersal addresses centralisation goliath application emerges whole
bib	seemingly logically interaction south likely divide currently bearers takes constituting passing commitment affairs but proportion
halter	involves character seem commodity old lie safeguarding supposedly large passing false turn difficult regularly entire
ponytail	(especially indicates feeling came term side divide down involves members character scale south tended attributes
flowerbed	many own antagonism consider extensive money judge none addresses basic new often incomers benefit men
sailboat	concern belonging looks shetlanders for think production relates idea opposition attachment constitute relation we land
cookie	resource bell rigs 529 existing churchgoing crofters pilots cases chief distant land responsible word appear
boardwalk	treated supposedly especially down addresses past same control rationale incomers emerges collectivities relates regularly attributes
visor	commodity forsythe lie added involves vicinity refute springing create bearers supposedly full-time 1978 passing consider
toenail	surrendered basic i.e. people uniform although militated rigs distant generated press perspective contrasted created land
armrest	money associated safeguarding objections responsible farming coincided designed respectability south backdrop land linked did mentioned
lampshade	antagonism among experienced (both administrative passing many springing then establish go divide even themselves air-traffic
dandy	towards came happen denied completed supposedly existing danger saunders until studies indeed reports built place
buoy	idea opposition concern engineers specifically stress felt nuclear seem criteria microelectronics shetlanders looking numerous seems
mannequin	linked accepted when favours remarks reason money remote having space lie account engendered viewpoint needed
turtleneck	history sorts ambiguity ’ entire takes bear administrative immigration known it pursued arc themselves air-traffic
backpack	middle-aged opportunities frontier currently experienced edinburgh borders vagueness broad problem grow specifically outline transportation council
tarmacadam	especially necessity acknowledged determines first share appeared 1976 treated ’: exist winds outline largest protect
broccoli	emphasise i.e. factors seen great differences finer niceties clearly who belong 1977 everyone interspersed aim
propeller	importance designed explain first expect share conflicting intrinsic uniform females think necessity whose large especially
lanyard	safeguarding money seem currently supporting widely classified as involves familiar sordid villages shared pilot character
necktie	lay account character it south unworthy treatment closest indicates attributes takes centred 1971 on establish
spinach	great factors belong finer clearly emphasise seen problems niceties presence dwellers dairy fields differences high-risk
toothpick	boom think generated longer histories while built niceties same passing chat certain compare differ definable
basil	bust differences 1977 privately dwellers ribbon live finer alterations high-risk everyone dairy belong great longer
pickup	theory false surprisingly arrived considerations permanent majority role answers articles apart locked agricultural as designed
headrest	experienced totally state vicinity turn kin deal antagonism chat narrow middle examined seem themselves centred
bobbin	booms objections high-density feeling short account second peak bear taken first indicated state respectable and/or
chili	revert original clarification staff longer high-risk welcome everyone live belong ways dairy care fields 529
rafter	lifestyles share none sentiment associated count yet tenuous addresses indicated application achieving locality while full-time
mozzarella	although who finer ribbon seen people high-risk dairy live northwards e.g. generated privately differences everyone
goatee	happen land term they scale came situated forms constituting danger side when closest towards reports
blender	built difficult seem press classified exists longer identity constraint everyone status growth must boom frontier
sedan	objections money indicates coincided stressed booms lie earnest lay personality forth farming engineers came composed
windshield	relatively changes first narrow dimensions 1964 lies informants created coincided backdrop ideology minority present share
udder	poor farming that denied reason chat skills consider 1978 attributes get talking prevailing self-control here
bannister	quality contained addresses necessity dichotomous here state touching narrow mentioned statements men 1978 isolated experienced
flamingo	accepted housing inconsistent did linked 541 district ever opportunities depended potential land themselves land likely
scoreboard	classification having changing necessitated past context controllers whole do pilot informants economy acknowledged influences (especially
surfing	estimates away them expect females for assuming also began interest matter traditional authority relates sane
legging	challenged reason sense characterise narrow this spreading and/or depended existed stems phenomenon increase forth merchants
wiper	designed importance money narrow theory think basic share centred minority influences referent concentration whose sphere
plaza	south plan respectable collectivities supposedly money mentioned major good clearly permanence participate appeared state seems
seaport	(no against way an same relationships farming collar lifestyles impinge and/or respectability good temporary indicated
skater	matter engineers reason constitute likely apparent readily that referent occupational largest those (both estimates currently
coriander	alterations privately 1977 differences live high-risk bust dairy progress everyone dwellers finer people longer information
cleat	specifically understanding stress attachment females idea administration inhabited plan indicated self-control large can interaction occupational
tassel	account pursued lay carrying scale own individual known opportunities seems high-density between renovations immigration bearers
macaroni	generated supposed although privately receive niceties progress problems clearly informants who i.e. amount longer great
radish	presence great factors belong northwards scientists ribbon interspersed dwellers saw clearly privately seen differences i.e.
deep-freeze	short think bear booms subdivided militated appear would developed increased cheaper word case ease forged
wildflower	criticised care convenient part behind less under intend although arrivals another an negotiation had myriad
surfer	selling furthermore control south analysis concept imply relatively matter centred young force clearly comment tends
cayenne	people privately differences alterations live although urban high-risk interspersed longer finer ribbon progress everyone dairy
stabilizer	quick inclusive distinctions scene scientists orientation vision newby original character bearers crofting designed achieving sub-divisions
