body	social in year provision conditions however unique contained postgraduate alternative health aspects locals take get
set	science to involved am way was tradition nascent suggestive studies for weapon characterised (something where
support	research really use right economic operate three oil instruction ideology social jackson against should creation
person	council correspondingly anthony combined well-known has besides doing value commercial since completed rather at discussions
paper	the alternative social benefit also use aspects take tel vital assuming right postgraduate big against
one	social economic use we benefit oil observed social why today not an journal instruction carry
oil	science jackson leisure ’, activated merely larger like right development special others literature anthropological during
year	research adopted vital those its essentially networks has claims engendered that politically saunders anthony cover
range	council nevertheless ’? london values e.g. clear-cut raised too without step general different compare perceived
form	is avenue carry we way yet most (something panel older perceived familiar controlled not interests
way	a are this temple processes encourage covered was series many its vital crichton pieces research
end	body life (june justified issue lies while their phrase so uniqueness examine fieldwork person about
two	set up 1975 benefit literature use economic social social should development right ideology today like
three	up 1975 set by convened views read papers occasional social should ’, social use jackson
five	by read views should 1975 up occasional convened papers set jackson results ’, social leisure
audience	royal anchored launched there servants locals they explain boot or knowledge of this take its
connection	charter forth what some threatened series centre isolated its acquainted concentration competition base identity crichton
cast	for to time liberty the intensive in are social alternative allow covered was locals felt
boot	the this launched in transportation possibility boot series denied said competition when time claimed was
there	promotion audience north thus gross away seminars examined readily sciences may uk system surprisingly era
large	of in too general panel ’? (7 e.g. above step experiences villages without industry nevertheless
business	social right in economic alternative disseminate the literature benefit big use ideology also these we
thing	science those has its such rather a claims to council felt predominantly locals assumption anthony
area	research encourage pieces common way which its impact was vital informed sane aspects public big
case	its which research encourage common pieces acquainted centre sane public was vital are a way
step	functions appropriate nascent relation behind for besides stems council redundant (see anthony that has belonging
position	are this a covered essentially incomer encourage processes when vital series postgraduate useful was aspects
point	to operate a covered knowledge liberty are temple aspects essentially vital its has adopted assumption
field	encourage pieces research was way common vital informed this competition series acquainted take alternative crichton
people	and social use economic ideology instruction oil research social an set creation should results literature
handle	support circulation defend expert affect answers collar changes deserved where produced presented decisions planning more
sphere	any panel books final issue make examples most sea population constraining fieldwork informed big contained
can	means membership gross churchgoing weapon promotion science tradition thus audience differ away results why north
small	in of panel industry above (7 general too bell assimilated experiences economy authority examination few
uniform	sciences reports allow another (2 redundant do health be above behind seminar panel yet social
outside	other section criterion goliath authors this being held rights suburbia determines concentrates same focussing dispersal
side	person justified about approaches attract examine uniqueness body issue life lies fieldwork papers population their
outline	or sea of most fieldwork 1979 final uniqueness against make constraining royal big books concept
phase	make final concept most books aspects constraining any issue sea fieldwork vital population uniqueness further
bracket	grants rights paper again incomers status role forum boot wider possibility opposition category debating being
scene	students again debating papers section authors rights claimed connection goliath theme role wider about determines
background	postgraduate aspects alternative take vital big in its are useful series tel when assuming most
information	instruction economic use social right scotland literature should social benefit an the oil like ideology
part	carry panel compare is journal sea familiar not controlled any connected most we given relations
bear	out is support presented defend affect deserved decisions circulation planning parts collar truth changes expert
down	provide produced us one immigrants medium local disruptive topic more types locally changes another cast
date	operate liberty knowledge against assumption meant prime covered servants uniqueness boot situation transportation possibility aspects
airport	services end see work goliath can this rat lies perhaps opinion authors life criterion found
direction	common pieces research encourage way public big sane informed its was examples centre impact alternative
land	use economic benefit social literature alternative against right the today oil scotland development should big
ribbon	carrying question high-density health spokesman also most aspect blue simply enquiries sector very public microelectronics
collar	on vicinity mercenary provision depends all luxury (1 almost get immigration edinburgh actually prevailing in
word	such claims anthony has engendered politically doing saunders its at predominantly divides networks a distinction
pilot	advice anthony claims has well-known doing networks felt extensive areas saunders distinction mcfarlane at predominantly
space	disseminate social right literature alternative these seminar ideology economic big allow point the also yet
base	knowledge when its launched dividing aspects against neighbourhood there locals take series servants boot communities
room	concerning forum this denied count competition category launched farms was centralisation claimed again crichton rights
scale	1 avenue country most priorities perceived familiar older microelectronics rhetoric ssrc relations (something hub particular
court	temple launched this boot when covered was a processes are paper claimed many denied category
group	avenue priorities rhetoric perceived older (something ssrc 1 familiar country most often hub interests different
degree	london nevertheless council raised clear-cut e.g. ’? too values way is (something different perceived interests
building	tel take assuming aspects alternative when series vital claims its locals postgraduate communities dividing question
good	north in bring exclusive panel second hence schooling possible of universities examination consideration numbers articles
image	sea figures final familiar or most books panel make troublemakers any concept fieldwork aspects issue
control	oil use economic today benefit three right an social like against literature development social we
short	panel in above of industry few too bell interests general economy outside within meaningful (7
house	this competition crichton motivations was concerning expanding processes suggestion category published forum denied launched are
market	paper section launched students boot again authors suburbia forum being determines possibility servants rights same
exhibit	one circulation where changes dispute locally cast am disruptive collar understanding support stems conflicting expert
line	series its dividing vital take aspects encourage again alternative communities informed when claims assuming this
back	produced provide circulation disruptive more us view changes support professionals locally defend collar things topic
pasture	under jackson wherever right ’, leisure others ideology creation use north these science literature anthropological
park	auspices the forum expanding follows category again crichton this motivations published so was mentioned competition
sheep	north anthropological ideology activated leisure ’, rationalisations right jackson another assume these hoped urban others
dinner	sea obvious individuals expressed away residence bring thus suggestive demarcated understanding rat redundant consideration dispute
coffee	oil countryside conducting ’, together staff jackson leisure activated productive rationalisations north had aim activities
formation	panel carry any books sea most final familiar issue make relations constraining phrase compare or
display	was nascent liberty vested afford conflict well-known to the also allow early 1 there (something
circle	ssrc priorities rhetoric perceived avenue often few hub country older (something yet major particular interests
four	1975 up set read by views convened occasional papers should social jackson ’, leisure merely
face	promote masters central talking along ease 385 unworthy prevailing arrived stand effectiveness unemployment wide-ranging thought
cake	into surprisingly question northwards ideologies unskilled subject actually facts receive allow ideology stress anthony carrying
material	economic use benefit social right we today literature during final social instruction against alternative like
hand	political almost effectiveness polarity along terms no promote could year origins said count masters david
air	impact matters faith way launched pieces both latter was competition research suburbia run literature so
traffic	scotland literature use alternative matters should right social recently etc rural benefit development faith dispersed
crust	oil take population effects assumption dividing tends aspects concept sustained assuming communities politicians early final
earth	developments engaged concentrated earnest sentiment what much approaches necessarily total sordid middle enquiry full-time equally
scope	now doubtless their books issue final panel fieldwork best any benefit (june phrase make sea
game	its series dividing claims locals vital when situation communities debating students again suggestion there aspects
structure	final books take big aspects sea constraining benefit most make against alternative issue fieldwork further
name	year social unique in there locals provision contained this its conditions transportation royal aspects get
document	has predominantly anthony felt besides at claims engendered networks value we politically saunders when facilities
shed	sponsored types stems felt motivations ideas cast meant local living value conflicting where intensive besides
detail	wide (2 housing sane public acquainted must common its instances results think centre nuclear origins
weather	range suburbia held focussing impact matters paper same launched concentrates section centralisation farms latter so
pot	enquiries meaningful davids few society bell most inhabited industry question sector aspect co-operation ssrc often
bit	universities those passing schooling cases exclusive second fishermen tended socially in i considered boom (7
eccentric	institutions close dominant larger find referents background with allow system instance lend right should another
writing	results social disseminate allow studies these use sciences oil-related employment another right economic merely social
agreement	some royal treatment important with companies form series dominant of david anchored should temple help
second	these when vital aspects locals claims its covered series dividing take this alternative tel situation
print	studies view creation point ideology right involved locally social wherever disseminate stems massive results these
road	being section determines wider criterion goliath prime theme experts dispersal this elicit papers rights role
shop	published expanding motivations suggestion two this isolated crichton subdivided intend new politically competition opposition category
bus	as opposition felt migration modern types time born ultimately predominantly intensive court division camps nationally
fabric	books final issue constraining benefit panel sea population make fieldwork any contained phrase most take
expression	journal carry sea compare we connected panel 1979 observed is pahl given or social not
magnet	articles temporary consideration second hence those each may numbers class socially race cases claim although
family	in social social postgraduate take right locals alternative get aspects big tel launched this vital
post	many this locals when claimed boot launched denied category servants its there felt series concerning
office	instances this said origins competition pieces was impact public research encourage sane are launched crichton
heart	however social conditions in health year social contained provision against alternative patterns big field incomer
scattering	an we also health benefit very most yet familiar today avenue field older relations country
light	alternative big take aspects pieces against the series vital encourage postgraduate most benefit literature final
item	form dominant with the essentially of has some royal vital aspects whom early engendered that
distance	publication intend when politically at stress suggestion new dividing a again expanding opposition apart felt
open	more disruptive produced circulation changes locally provide support expert collar immigrants us things defend stems
letter	appropriate besides commercial few well-known anthony nascent division areas has doing rather at at davids
spoke	it creation produced results view defend decisions collar studies research refineries deserved wherever bears tradition
toilet	medium farms local immigrants us topic possibility boot work types status prime count launched being
goal	that claims locals anthony doing well-known essentially question its useful saunders particular has davids there
gate	this authors goliath fundamental section rights incomers being criterion role application theme elicit determines intrinsic
nine	occasional views read convened papers by 1975 up set should jackson ’, leisure results anthropological
twelve	papers convened occasional views read up by 1975 should set jackson results creation ’, ideology
gap	been role debating forum rights again category processes students wider crichton actual intend incomers application
church	launched claimed way servants pieces this work take paper was authors boot again there denied
nothing	martin presented is bears defend affect decisions deserved weapon planning collar more support out parts
eight	views read occasional by 1975 convened up papers should set jackson ’, results special social
home	expressed rat sea services view end redundant point produced motivations obvious provide can away individuals
day	those its opposition claims felt possibility locals stress series situation again dividing politically boot debating
window	authors this section goliath application papers rights students incomers servants theme claimed connection determines again
section	not panel carry is most we make any familiar sea final alternative controlled avenue economic
page	necessarily engaged middle enquiry much go the early some sordid developments nationally earnest what would
object	of or royal sea dominant 1979 with operate aspects against economic should final covered most
tape	the socio-economic enquiry nationally go engaged much intensive ultimately early as some whole time possibility
round	one established medium provide authors immigrants local servants count suburbia launched concerning other possibility denied
picture	priorities rhetoric avenue ssrc perceived often few particular hub country older major familiar different (something
inside	established other authors one suburbia sited concentrates criterion explain papers count status incomers section intrinsic
landscape	take aspects alternative final big sites launched vital series way again dividing assuming tel encourage
door	fundamental this authors section goliath other criterion held same being concentrates focussing rights accept intrinsic
sign	look way (something raised afford avenue too london perceived different is older rhetoric few nevertheless
dish	at commercial meaningful industry davids agriculturally society bell economy course cost few enquiries at consideration
filling	what competition this encourage series sane public faith pieces impact was nuclear instances crichton alternative
mark	meant felt types ideas cast wider possibility prime topic value boot local nationally besides liberty
worker	‘ anthony at well-known distinction correspondingly commercial doing sharp has actually extensive predominantly value politically
city	way pieces connection launched encourage informed run claimed take fieldwork latter there population research was
tourist	life areas politically networks at suggestion well-known when anthony subdivided facilities claims doing saunders a
parking	’. quantitatively disseminate ideology another follows allow point social right away jackson expect these the
drawing	to allow tel time conflict redundant the was for vested question social intensive behind in
bay	end services increased rat work goliath neighbourhood claimed impinge found perhaps knowledge elicit life motivations
book	adopted essentially networks saunders vital are cover has that areas claims incomer doing politically its
car	two suggestion published this politically expanding motivations apart opposition housing intend subdivided felt facilities new
island	approaches attract justified about run papers person fieldwork equally five issue examine population uniqueness emerges
belt	(1 depends all actually mercenary vicinity provision almost effectiveness case on subject opposing facts division
water	literature development benefit rural faith matters recently alternative right big both social use impact etc
man	combined since completed how race correspondingly commercial numbers distinction council class doing sharp anthony well-known
employee	with dominant treatment royal find of instance some however or form anchored important should 1979
farm	intensive time possibility felt opposition motivations as education boot modern migration when nationally stress types
opening	fieldwork way run there population contained books issue final pieces informed take uniqueness about alternative
supply	three against use right oil economic today big benefit social of alternative or final most
newspaper	areas networks at politically saunders well-known society commercial anthony doing claims belonging essentially (see behind
manner	(2 sciences incomer essentially are yet expediency acquainted redundant reports adopted seminar public (see areas
standing	seminars uk redundant what this time to instances for two published intensive maintain scotland nuclear
measure	way (something afford look avenue is raised too london perceived older few rhetoric different priorities
bottom	life body lies justified about (june so while attract examine emerges uniqueness their person population
swing	stems cast where types living local meant sponsored liberty ideas felt nascent motivations tend covered
note	from appropriate nascent few besides council rather davids has well-known there liberty suggestive discussions way
crest	five justified uniqueness effects approaches early about examine concept sustained population objections constraining papers most
coat	have choose immigration south takes unemployment springing vicinity mercenary on 385 logically explicit entire gives
sun	held focussing suburbia section concentrates same connection latter other centralisation dispersal goliath application appeared this
ladder	regularly interest occupational 1978 wider politicians statements rights prime theme 2 effects debating being role
woman	since combined numbers race completed how correspondingly class commercial each distinction behaviour sharp at consideration
map	early objections assuming assumption claims stress 2 effects dividing whom series communities transportation its before
overall	1979 or sea of final fieldwork books panel issue run benefit big journal (june use
bride	edinburgh in opposing locals added provision national deal various migration denied capital-intensive year explain social
six	convened papers occasional views up read 1975 by set should jackson ’, results leisure anthropological
lady	dr combined how completed since distinction era pilots saunders anthony extensive sharp employer council commercial
child	anthony well-known engendered doing at value has era distinction claims predominantly commercial politically besides networks
food	jackson leisure others ’, activated activities anthropological quantitatively science north during right welcome merely special
bread	aim had activated welcome others activities who jobs encouraged leisure problems urban seen jackson ’,
drink	bring residence possible amount our sorts agriculturally north schooling growth whether sphere tended deliberately crofters
wine	together conducting ’, merely leisure activated consensus staff during jackson like separation rationalisations these oil
butter	everyone who niceties problems welcome jobs aim progress permanent seen had urban factors ribbon others
cheese	who seen everyone aim problems factors niceties ribbon had welcome jobs encouraged permanent supposed belong
fruit	had activated aim leisure others welcome urban ’, jobs jackson rationalisations activities encouraged north negotiation
beer	conducting together consensus merely ’, these vaguely staff during leisure health allow oil simple also
cattle	anthropological jackson north activated leisure others ’, activities science merely rationalisations right welcome jobs part
soil	recently literature rural faith development matters benefit listen both alternative use industries dispersed etc impact
corn	hoped right ideology these leisure during social benefit also staff ’, literature another north activated
corner	informed way encourage pieces claimed series dividing population take again company students fieldwork alternative sites
barrier	discussions besides value has anthony felt ideas nascent cast at new rather liberty conflicting predominantly
foot	could intensive possibility time early unique alternative before help series in this polarity prime knowledge
bag	be aspect meaningful cost incomer facts redundant society enquiries health effectiveness inhabited division whether bell
girl	how combined distinction since race completed sharp era commercial correspondingly extensive each saunders anthony employer
banner	affected claims tends particular minority early a dividing its politically objections stress such at question
symbol	different rhetoric priorities perceived too avenue major raised (something general older hub objective few interests
produce	parts of is truth decisions deserved presented expert circulation support affect defend one out planning
liquid	seminar yet social also aspects disseminate allow alternative question we big postgraduate right another these
arm	wide-ranging stand arrived talking phase thought unemployment central industrial 385 promote prevailing masters myth definable
key	covered are when aspects these liberty temple this locals series launched vital claims postgraduate alternative
text	aspects take vital alternative big final series postgraduate most its further when encourage tel dividing
sword	all vicinity mercenary depends (1 on immigration actually international almost choose case provision luxury effectiveness
event	which its research encourage way centre was pieces students common competition crichton informed launched impact
memorial	were appropriate besides nascent suggestive may anthropologists discussions correspondingly residence relation race well-known where anthony
gauge	directly cast where circulation meant support topic answers types professionals stems local conflicting ideas disruptive
reign	connected carry compare panel journal given any not sea examples we is books issue pahl
blood	oil-related literature social development ’, merely leisure benefit part right staff use these like activated
clothing	activities others activated jackson aim jobs welcome leisure had anthropological ’, urban encouraged quantitatively rationalisations
roof	papers section about theme determines authors students goliath criterion incomers being again effects shetland connection
leave	presented is defend bears affect planning support decisions circulation deserved truth expert collar out produced
figure	essentially are adopted networks incomer politically saunders claims vital facilities its has suggestion areas doing
sea	work goliath launched authors section lies suburbia servants this perhaps claimed criterion latter debate paper
flour	progress welcome jobs urban activated ’, everyone north leisure rationalisations had niceties others aim negotiation
wool	’ leisure activated ’, merely during benefit like development part staff literature right jackson consensus
costume	reports sciences another allow redundant effectiveness be social facts incomer disseminate in taking behind health
ten	should by read papers views up 1975 convened occasional set results jackson social studies social
seven	read views by occasional 1975 convened up papers should set jackson ’, results leisure anthropological
gentleman	completed combined since commercial race how correspondingly distinction numbers sharp doing class each anthony saunders
town	pieces way encourage launched alternative common big research was informed take impact competition this aspects
pile	nevertheless e.g. london ’? council too values raised clear-cut general perceived (something step without interests
ship	felt opposition stress possibility value boot predominantly types category new time locals when migration has
walk	deserved circulation decisions collar affect defend changes where support planning weapon bears answers am presented
path	wider rights being role debating prime image authors section regularly category theme students incomers boot
drive	circulation deserved support collar where defend changes affect expert answers produced decisions cast planning locally
wedge	because few general too study perceived often rhetoric industry (something different major interests priorities objective
remainder	their issue examine body justified books population run fieldwork about (june examples concept life way
wheel	intrinsic authors rights incomers this goliath theme elicit papers role students section concentrates determines criterion
hill	interest regularly politicians occupational absorption being 1978 wider papers section theme statements prime contrast determines
iron	larger activated science ’, leisure rationalisations jackson others urban merely consensus right like development welcome
plain	audience allow another behind point ideology surprisingly redundant placed networks anthony into examined social facts
river	section connection being authors goliath papers determines dispersal criterion about this theme students latter focussing
lion	dominant claims particular question sector a minority priorities microelectronics identifiable various dividing stress extensive most
lamb	ideologies allow into but also most question receive carrying health public within clearly our another
breast	local masters conditions promote arrived stand basic however 385 taking central industrial talking traditional logically
tower	communities dividing again debating its when assumption series take claims tends students actual sites boot
scarf	it sorts attributes grew yet choose divide commitment contrasted that possible gives comparatively schooling equal
art	observed given we journal economic merely social oil during like special use benefit consensus today
valley	connection section latter way students focussing authors papers about politicians same application dispersal held determines
bend	local medium us topic meant cast immigrants types stems another living felt ideas where boot
spectacles	communities create unemployment arrived goals talking immigration prevailing 385 international industrial central wide-ranging thought councils
rectangle	often priorities rhetoric ssrc perceived study few avenue co-operation hub davids (something particular most major
cross	cast where types conflicting meant ideas stems besides felt value local discussions living tradition nascent
bridge	role rights incomers wider sited this authors again theme being section students debating elicit concentrates
eye	david royal important could help polarity no effectiveness possibility intensive time treatment almost in social
port	against alternative most big final constraining benefit aspects take knowledge right books postgraduate use today
ceiling	goliath criterion section authors this elicit being papers theme students work dispersal determines incomers rights
inscription	companies important treatment royal policed none some students explain elicit anchored dispersal application goliath again
umbrella	however anchored royal treatment with sea dominant own respectability figures important or david find policed
square	spokesman question avenue yet country most sector 1 useful particular ssrc assuming claims aspect health
student	well-known anthony doing davids claims commercial there areas most question at society has advice that
shadow	company most alternative yet informed vital big take aspects dividing series encourage tends country incomer
palace	claimed launched students authors forum servants again way this category denied was connection sites section
enclosure	they launched take run servants way fieldwork about lies there authors work section population final
shelter	really launched knowledge when in this against boot right postgraduate neighbourhood servants concerning alternative transportation
coin	davids few most commercial enquiries doing well-known meaningful priorities high-density at often society there question
chain	country most priorities avenue familiar 1 rhetoric particular ssrc relations older microelectronics question perceived yet
bank	boot again possibility when category felt launched wider intend opposition paper this servants debating role
desert	was competition crichton this encourage forum so pieces processes launched where again claimed base meaning
foundation	doubtless concept situation most there familiar unique troublemakers aspects uniqueness final knowledge make fieldwork constraining
head	central promote arrived talking prevailing industrial wide-ranging patterns unemployment ease thought argue masters stand 385
friend	government schooling possible tended choose in sorts examination divide gives equal villages bring institution whether
shelf	would modern much go addresses contrast middle court forge what elicit shetland nationally whole corollary
rock	also these right very social allow the benefit health answer ideology we field blue our
doll	claim each race consideration grew since commercial distinction sharp situated class at era numbers attributes
wire	simply assuming stress question also take tel right in time carrying transportation very field early
crown	servants there authors launched claimed about section papers students boot wider 1971 effects paper work
spring	public sane pieces encourage common alternative big nuclear instances research was faith acquainted literature impact
stomach	masters promote arrived along stand conditions local talking terms effectiveness central example unemployment basic wide-ranging
blind	thus residence understanding cast tradition nascent behind anthony suggestive dispute constraint where actually conflicting discussion
shell	question particular claims a most whom sector useful high-density aspect country assuming politically microelectronics well-known
wave	raised too nevertheless (something perceived different london e.g. clear-cut avenue interests older general major rhetoric
curb	truth is expert parts presented support affect planning circulation defend dwellers collar bears out decisions
rear	lies life about work authors section body goliath servants so emerges launched fieldwork politicians connection
flower	behind society areas redundant networks at conflict politically anthony point well-known motivations suggestion published (see
horn	opposing migration stress actually national 358 subject locals time opposition added get recent various camps
band	claims locals dividing its when stress a particular various politically question doing anthony minority early
vessel	we felt claims its opposition communities has dividing when debating a intend situation stress locals
angel	concerned find with referents instance treatment dominant before supersaturation close however institutions none non-technical peak
tooth	here agriculturally far whether behind actually cost meaningful facts unskilled be society areas northwards sphere
piece	values ’? without step nevertheless e.g. council london came clear-cut too raised general fishermen of
dress	taking air-traffic be reports facts redundant that another logically south whether constraint to allow behind
pine	decisions rationalisations had activated urban north vaguely ’, consensus leisure conducting these welcome merely another
tree	at politically a anthony commercial suggestion engendered has predominantly saunders extensive areas facilities claims stress
glove	level redundant two published expanding suggestion politically (see isolated apart case motivations expediency belonging effectiveness
narrative	we economic social is benefit avenue an familiar aspects most also big final today health
mouth	talking industrial thought promote central unemployment wide-ranging arrived stand masters 385 prevailing definable lie determine
surface	about papers section justified attract emerges politicians approaches population lies connection servants students effects examine
pull	planning affect circulation presented defend deserved support bears decisions is weapon collar expert changes produced
horse	actually distinction case unskilled sharp era migration anthony subject predominantly mcfarlane division commercial extensive upon
neck	arrived unemployment central wide-ranging stand masters conditions prevailing talking industrial 385 promote patterns suddenness on
cart	national camps time migration 358 stress housing opposing status opposition possibility again does maintain intensive
drain	who living prime types modern felt nationally wider addresses being possibility much what opposition large
highway	determines section papers being theme criterion authors rights incomers goliath students again this shetland about
sole	best there fieldwork books issue final their run concept about population doubtless way aspects take
wild	another allow these ideology social right also answer point very in sake disseminate our seminar
title	there servants way fieldwork launched students its claimed about aspects concept take series paper population
mother	determine industrial side stand unemployment talking masters 385 arrived promote wide-ranging central thought definable have
mound	major rhetoric perceived priorities hub older different (something avenue ssrc often objective interests few raised
check	affect circulation defend support decisions deserved planning changes presented collar bears expert answers produced where
wall	theme papers incomers determines section elicit being rights criterion authors goliath shetland students role wider
watch	bears presented defend affect circulation decisions is planning deserved support produced expert collar changes provide
counter	topic see medium meant local experts us types being full-time prime wider cast image role
holder	concept uniqueness population about constraining assumption sustained make politicians there effects dividing issue final books
pool	used claims dividing question particular a yet aspect politically sector useful assuming its country priorities
cut	weapon circulation changes deserved answers defend planning collar affect where locally involved am produced more
canvas	enquiry engaged go early much some ultimately help the the vested socio-economic time would nationally
ad	debates dominant with find royal form treatment background david should some important of instance none
finish	defend circulation support affect decisions presented deserved bears answers collar changes planning expert is produced
plate	vested number cost neighbourhoods subject socio-economic ultimately early facts high-density was aspect actually health division
cloud	interests perceived (something avenue too rhetoric ssrc few priorities general raised above major objective often
dressing	community to expect motivations effectiveness redundant reports point another what in native immigrants get behind
stream	perceived rhetoric avenue priorities (something ssrc major older interests hub often objective different 1 few
address	disruptive locally more produced provide topic changes medium local circulation us professionals expert cast immigrants
ivory	change larger science activated merely jobs ’, activities jackson leisure anthropological special welcome others oil-related
skeleton	particular claims priorities question rhetoric country a microelectronics sector doing dividing most avenue whom ssrc
wing	articulate papers about servants authors effects students there section politicians determines take population connection debating
trough	actual debating again category dividing intend communities when students its wider boot claimed sites new
police	debate suburbia work launched real paper section time boot authors servants goliath possibility being temple
link	threatened cast been discussions ideas besides value felt conflicting meant where types role establish stems
package	there well-known priorities few davids doing avenue most often rhetoric outside particular study commercial question
vein	occasions essentially incomer politically suggestion are networks at expediency vital facilities a two areas its
museum	when intend locals boot claims dividing this its new suggestion again communities motivations felt launched
root	phrase books issue body (june uniqueness final so make fieldwork panel life concept constraining any
spectacle	familiar most relations avenue sea country priorities 1 older troublemakers rhetoric panel final doubtless aspects
board	engaged much what concentrated earnest middle addresses total some modern go shetland elicit nationally papers
frame	useful claims question aspects its when incomer series transportation locals politically vital postgraduate dividing are
portrayal	compare carry panel connected journal clear-cut london is council controversy given nevertheless familiar sea raised
male	our right sake also allow ideology social in these very another answer question seminar an
ripple	experiences general too interests few perceived e.g. objective raised because industry (7 (something above different
table	elicit goliath shetland theme incomers addresses criterion what status rights being much context again papers
train	types felt time nationally as cast meant ideas possibility value opposition intensive conflicting modern living
bill	situation assumption its dividing claims debating locals 1971 we students communities early there objections when
lane	probably wider mentioned rights being forum section so image occupational again authors debating interest connection
slump	acquainted encourage crichton isolated was competition this expediency processes are expanding centre housing base pieces
aftermath	examples any issue their way common run fieldwork panel body population books pieces informed (june
dock	where centralisation so base forum was crichton competition farms centre appeared meaning concentration same mentioned
lever	large modern felt court value migration opposition predominantly 171 possibility kind as status camps education
shape	big alternative take final pieces aspects against benefit most postgraduate literature encourage company vital social
ice	business rural literature matters recently development should listen industries faith use benefit fertile equally alternative
marina	impinge when again found intend motivations category forum this suggestion claimed boot expanding debating actual
beach	what much addresses total concentrated earnest middle elicit engaged accept contrast ln experts being modern
edge	justified examine attract approaches about person issue body uniqueness life five their population concept run
layer	are familiar priorities relations avenue older rhetoric perceived country most major 1 controlled hub different
steel	rationalisations activated north ’, urban leisure jackson these merely larger others consensus had welcome science
brick	taken but above within do meaningful industry allow agriculturally carrying economy cost bell community clearly
slope	politicians interest about connection section effects papers population regularly authors concept determines students wider servants
seed	neglected right in literature ideology social alternative aspects field benefit against really should take development
median	pressure avenue familiar most final country relations older sea these panel 1 priorities aspects we
plumbing	groups right rural literature fertile native ideology listen faith activated development north in leisure matters
drop	involved am stems where nascent our studies characterised them tradition suggestive view appropriate dispute deserved
index	if fieldwork royal aspects politicians or take tel final sea should anchored run alternative they
street	so forum mentioned competition centralisation same where was again appeared crichton meaning base connection section
furniture	activated others leisure jackson ’, merely like activities urban had rationalisations north welcome part aim
hotel	motivations expanding published this suggestion two when intend new felt subdivided crichton category neighbourhood politically
suit	dispute understanding where our decisions cast constraint one tradition circulation residence involved females characterised am
dispenser	pits again sites launched criteria suburbia take explain category boot when communities authors various denied
team	locals claims its when felt dividing stress boot various situation series assumption these communities suggestion
equipment	others jackson activated leisure activities welcome ’, had aim anthropological urban jobs quantitatively north rationalisations
clock	context elicit rights this incomers role theme goliath concentrates being students authors section intrinsic status
sitting	uk seminars redundant published this expanding to what origins view time identity terms instances two
blackboard	whole much court would middle modern go forge what as contrast nationally ultimately earnest addresses
design	right social ideology literature in benefit these against answer economic also during big disseminate point
seashore	ln total accept what experts wish concentrated addresses among much being collectivities earnest theme criterion
mountain	assuming early take 2 dividing tel series objections claims tends alternative most aspects communities stress
railway	thing launched time again possibility boot debate take when papers sites work authors intensive paper
station	opinion role found goliath this forum rights elicit authors category students concerning claimed possibility launched
milk	’, leisure jackson activated staff merely together right others north urban part jobs these science
bottle	general too e.g. few experiences different perceived developed because interests objective industry above raised nevertheless
clay	consensus merely these during also conducting like leisure benefit ’, very separation staff right together
storage	quantitatively jackson others leisure activities activated ’, anthropological science during merely vaguely rationalisations welcome fields
pair	’? values without step e.g. nevertheless council london too general raised clear-cut came of fishermen
plastic	do but above sphere sciences within public ambrose industry another allow in clearly taken ideologies
floor	accept total wish concentrated experts ln what being criterion among addresses theme elicit section papers
guard	democracy types ideas nationally felt intensive meant time possibility as divides much cast living court
block	liberty covered transportation useful when felt nascent claims objections afford early are value has besides
sandwich	possible sorts agriculturally cases amount tended deliberately grew sphere equal crofters institution comparatively bring (especially
cabinet	area locals two suggestion when this published politically intend maintain motivations felt new housing opposition
computer	conflict well-known behind value anthony looking question has networks areas predominantly when liberty at politically
match	ideas felt meant types besides cast value motivations discussions boot stems possibility liberty new locals
panel	assumption dividing situation early communities effects concept claims students objections series its locals debating aspects
terminal	either when knowledge tel take aspects series locals neighbourhood its claims again communities assuming intend
sand	rural faith literature matters development listen recently fertile dispersed etc industries benefit both attempts impact
salt	urban activated jobs welcome ’, leisure others had rationalisations jackson north aim negotiation activities larger
bead	orientation commercial number high-density davids cost neighbourhoods most at vested few study course at enquiries
lens	as stress a politically predominantly new at claims intend engendered migration we various suggestion opposition
machine	predominantly migration engendered felt has opposition 171 politically anthony stress value at intend facilities suggestion
motor	follows tel take aspects when assuming in question various either locals right claims the point
animal	dominant with of should royal find background treatment right or sea form 1979 social ideology
fish	ideology right social in point these also answer literature neglected another our north should disseminate
armchair	must origins none instances think important david effectiveness terms research always along dichotomous acquainted said
adult	lend dominant observed larger should 1979 science social special economic right journal use disseminate with
tongue	industrial unemployment talking central stand arrived thought wide-ranging 385 promote determine masters prevailing side definable
circular	economy at commercial meaningful davids industry few bell within course most well-known society cost enquiries
card	upon actually distinction sharp era migration case predominantly at unskilled 171 anthony subject division commercial
radio	depend today the time intensive enquiry internal does argument camps as applies whole listen much
television	today depend enquiry productive the applies under was graham the internal these vested native listen
cycle	further aspects take final make concept most dividing constraining assumption vital books sustained tends there
pin	characterised nascent where cast understanding living changes involved stems circulation females tradition conflicting constraint suggestive
garden	competition forum crichton this was so concerning isolated meaning again encourage sites base denied expanding
nose	unemployment arrived industrial stand 385 talking immigration prevailing wide-ranging lie international thought central have promote
grade	welfare right point in social alternative literature tel ideology take big aspects postgraduate seminar either
cat	sharp distinction commercial era extensive actually at anthony spreading owned unskilled race saunders how case
dog	distinction sharp actually era commercial case anthony extensive how at saunders predominantly mcfarlane migration 171
lamp	between opposition migration 171 court predominantly stress felt extensive politically status modern forge camps born
meat	leisure jackson ’, activated others like merely during staff right part had north development science
cane	then all depends on in get aware but mercenary health luxury facts provision surprisingly vicinity
entrance	see this topic being goliath section experts work authors fundamental image wider lies role servants
antenna	supporting question claims whom particular there doing most microelectronics early engendered well-known priorities a at
leg	almost provision effectiveness depends facts (1 could in mercenary social polarity opposing actually year get
skin	conditions social in year however provision arrived get problem names masters field luxury established patterns
row	co-operation inhabited few often course enquiries priorities davids meaningful ssrc industry study bell rhetoric perceived
goat	multiple sharp unskilled extensive distinction actually commercial at far predominantly era migration anthony stress mcfarlane
hole	occupations (see belonging politically expanding published suggestion isolated at presumed subdivided two apart facilities expediency
ankle	kin stand 385 residents logically phase wide-ranging unemployment masters arrived along promote david springing traditional
reception	neighbourhood when motivations knowledge this locals suggestion its many boot possibility felt dividing time found
parade	help possibility early much engaged modern time nationally intensive prime opposition felt objections shetland go
desk	no could proportion phase so-called polarity effectiveness argue intensive elicit almost david earnest much deal
chalk	separation leisure consensus blue activated these benefit also right rural like development during merely ’,
seat	polarity effectiveness two this competition suggestion crichton category expanding denied incomer forum concerning opposition published
gun	case actually distinction migration mcfarlane owned 171 division unskilled era two politically sharp stress apart
pottery	merely consensus activated during like leisure ’, together these benefit conducting science right jackson oil-related
vegetable	convenient receive rationalisations belong another north but show position clearly urban northwards factors vaguely ambrose
alcohol	dichotomy activities jackson special others jobs welcome ’, fields encouraged activated aim urban merely leisure
telephone	argument time as intensive types felt value migration possibility camps does national imputing opposition 358
female	sake our right ideology allow another also these social answer very in north blue point
stop	is presented defend bears truth parts planning support decisions out circulation affect deserved expert collar
cheek	myth stand example thought phase wide-ranging definable promote 385 persuasion so-called ease industrial talking masters
label	divides felt modern opposition predominantly value nationally corollary possibility has such types migration as 171
horizon	wish accept total ln concentrated what addresses experts among being theme criterion elicit section papers
rope	stress felt claims a politically opposition migration predominantly before transportation locals suggestion identifiable early as
ring	tradition where cast nascent living stems conflicting immigrants types handle local meant circulation ideas felt
player	correspondingly combined race since class commercial completed council distinction anthony numbers doing well-known sharp 1968
baseline	rat end knowledge neighbourhood services motivations work intensive either point when increased found can really
policeman	race since combined numbers class how correspondingly distinction completed commercial sharp each behaviour consideration broader
winter	sane public nuclear encourage pieces common research competition impact was faith instances acquainted centre matters
night	humane research greenfield those possibility time intensive increased its neighbourhood opposition 358 this found motivations
slide	living types who stems felt tend cast immigrants conflicting time local meant value another new
couple	step ’? without values e.g. nevertheless council fishermen came general too london of (7 experiences
bruise	consider gives likely actually number division cost grew distinction race sharp socio-economic vested attributes case
pitch	possibility prime boot modern again felt opposition time elicit papers intensive role category launched shetland
crowd	dividing claims debating communities tends its series assumption when again sustained take locals students actual
missile	districts conflict networks areas at politically well-known predominantly question anthony has claims engendered a migration
bunch	without ’? step values e.g. nevertheless council came fishermen london of general too (7 raised
coach	imputing felt time migration value intensive types locals possibility opposition when as national boot motivations
customer	value felt besides anthony predominantly has when stress migration new boot intend discussions locals engendered
accent	system actually remains distinction facts cost neighbourhoods surprisingly case division era whether upon depends sharp
fire	time possibility intensive felt opposition maintain boot again stress types when national new camps as
fist	grow lie international all does vicinity mercenary unemployment feeling immigration residents choose prevailing councils 385
knock	around answers where characterised cast little types tradition changes living administration circulation democracy who nascent
bird	commercial sharp distinction at anthony doing at davids saunders most well-known completed areas cost race
crack	nascent liberty well-known besides anthony discussions felt was value has at behind cast doing motivations
sheet	towns priorities rhetoric perceived microelectronics high-density hub often 1 few avenue question sector particular ssrc
nut	locked unskilled actually migration far does predominantly sharp distinction subject era than at value 171
linen	position rationalisations ambrose north show activated blue urban another receive jobs welcome ’, separation had
garage	expanding published motivations isolated this crichton suggestion two competition intend forum new subdivided processes was
vehicle	communication anthony engendered at doing well-known commercial has saunders claims that distinction predominantly politically may
magazine	networks areas politically facilities has suggestion two essentially claims saunders anthony at when subdivided predominantly
ear	along promote masters origins terms effectiveness view political instances 385 talking central wide-ranging ease almost
cape	yet choose whether that sorts grew it sphere attributes growth commitment explicit gives actually entire
knife	grew attributes comparatively commitment agriculturally class at consideration growth numbers cost that whether each case
vegetation	like benefit attempts development literature during right leisure activated economic merely rural use today part
wind	suburbia held section concentrates focussing same authors launched explain mentality application work paper share goliath
plant	point right motivations ideology when behind intensive in tel time this social either published really
binding	manufacturing use economic social right the against alternative instruction was ideology these also three operate
dune	began listen assuming national take simply stress does judge 2 time camps tel right early
straw	greenfield in right ideology another time tel point get national simply social housing also native
basin	sites again forum take competition application debating launched claimed was criteria communities connection category dividing
wood	benefit literature final big books today alternative development economic attempts use against social like right
grain	today benefit against economic right use big social final literature alternative field development we also
lake	again sites forum category students debating application rights incomers communities authors papers intend opposition boot
hedge	new suggestion intend when felt politically category again opposition published motivations boot this two stress
grass	industries equally papers matters section goliath suburbia work about criterion attract impact launched determines become
rubber	but public do above ideologies within allow carrying receive clearly another also into cost blue
litter	very also these right social health answer benefit allow the an another alternative blue field
nitrogen	green special activities merely component activated dichotomy others jackson together consensus ’, encouraged science aim
beef	fields jackson leisure others ’, activated activities welcome aim anthropological had merely north together jobs
dust	development literature rural attempts benefit like faith recently matters right part events fertile listen use
bowl	industry bell meaningful few at community enquiries general above inhabited agriculturally co-operation davids economy study
leaf	within davids meaningful economy most enquiries industry at bell society few high-density commercial cost above
canopy	tends dividing sustained communities take assuming effects claims series assumption its aspects debating most 2
rice	welcome jobs others activated urban aim leisure ’, had jackson activities negotiation rationalisations north encouraged
shrub	provides receive belong sphere but do according factors clearly growth struggle far northwards demarcated deliberately
tissue	employment merely social these consensus oil-related economic benefit we literature disseminate right during another also
bean	lose agriculturally far according commercial although cost sharp unskilled at meaningful agriculture distinction actually clearly
sugar	jobs welcome urban ’, activated aim others leisure activities jackson had rationalisations negotiation north encouraged
herd	older avenue rhetoric perceived priorities (something hub ssrc 1 familiar major country relations most different
terrain	become take final run books industries potential equally they fieldwork way about benefit matters alternative
flat	redundant effectiveness incomer two behind motivations (see published expanding for suggestion this belonging division politically
bark	field benefit against alternative take in final right big aspects today also social literature most
acid	usually special science jackson merely ’, activated larger leisure others urban dichotomy activities jobs anthropological
frost	placed literature right these social development also very rural ideology another the allow benefit in
habitat	near social right allow question ideology during also our disseminate purposes in another very seminar
pineapple	centres northwards receive ideology does another into right demarcated dairy placed listen clearly national native
banana	deliberately agriculturally possible amount sphere according although growth notion but comparatively far grew agriculture sorts
shade	yet company ssrc incomer most country avenue big question alternative health vital postgraduate useful spokesman
phosphorus	wishes activities others aim jobs welcome activated had urban encouraged rationalisations who problems everyone negotiation
mat	go much would court modern middle forge engaged shetland early addresses whole contrast nationally some
mulch	true of in too villages e.g. experiences general without assimilated ’? above step industry (7
skiing	away ideology allow point another social reports disseminate redundant surprisingly jackson expect behind results right
periphery	attract approaches justified about papers examine emerges person run section accept equally life industries population
boat	opposition felt category again possibility modern suggestion intend politically stress predominantly two migration boot new
rubbish	why social economic social might we use benefit merely observed an also consensus leisure the
herb	care convenient another receive northwards behind clearly but ideology north surprisingly allow rationalisations show point
bed	view studies locally stems produced redundant immigrants instances changes origins terms another us types sponsored
aircraft	should literature right use alternative social scotland in benefit royal development ideology against matters economic
gravel	listen rural judge fertile industries faith matters literature development recently dispersed equally take attempts right
photograph	few priorities rhetoric davids study often ssrc industry perceived co-operation bell inhabited enquiries (something there
trail	objections early claims assuming assumption dividing situation series transportation effects stress 2 minority its tends
covering	people dividing its take servants there tends effects 1971 politicians debating sustained population fieldwork authors
motorcycle	protect grew numbers gives comparatively agriculturally possible attributes schooling equal sorts eyes composed exclusive consideration
ski	them behind nascent redundant point involved conflict stems was motivations studies liberty view relation well-known
ridge	effects papers about 2 politicians determines assumption again wider students dividing theme debating early servants
swan	spreading sharp distinction commercial actually extensive unskilled at case era owned mcfarlane race politically broader
tea	countryside oil conducting together ’, jackson leisure merely observed staff consensus fields during activated quantitatively
potato	clearly northwards receive far into ideologies but within allow another behind most unskilled according surprisingly
tomato	high-risk who seen aim factors ribbon problems had everyone welcome encouraged urban belong jobs rationalisations
carrier	need when felt stress intend value boot locals claims opposition various new suggestion predominantly politically
oxygen	special jackson merely ’, science leisure activated like others oil-related during observed consensus larger component
meal	consideration class at agriculturally commercial race broader grew each numbers behaviour correspondingly since distinction may
cement	wherever right creation these ’, jackson ideology under leisure rationalisations development others activated science answer
crossing	sited role authors rights incomers section students papers determines debating application theme this concentrates again
butterfly	although commercial sharp at class each far agriculturally specified distinction cost comparatively grew broader unskilled
weed	well ideology right social also answer field liberty these simply in very question neglected point
thread	high-density question priorities most davids few rhetoric perceived sector particular often avenue ssrc hub microelectronics
mantle	population about concept politicians way examine sustained run connection uniqueness fieldwork books issue informed effects
device	may commercial there communication has correspondingly at anthony race well-known rather doing 1968 davids hence
track	prime being possibility wider modern papers boot role theme occupational regularly determines much section servants
hardware	considerations others activated jackson leisure welcome had urban aim north activities jobs rationalisations ’, anthropological
curve	characteristic students there about debating paper assumption connection politicians wider concept situation section servants papers
platform	modern much corollary possibility elicit opposition would nationally addresses shetland prime what role felt court
driver	capital-intensive various felt opposition role debating rights category locals 1971 boot claims when wider denied
trick	rather has besides anthony doing discussions commercial distinction may saunders such well-known claims value felt
printer	than value predominantly migration anthony actually does locked besides has felt unskilled conflict engendered 171
button	labour-intensive modern 358 court large opposition corollary camps migration status predominantly changes stress 171 perspective
tool	hence may consideration outside communication articles there at class broader commercial remote correspondingly viewpoint economy
keyboard	does 358 migration camps predominantly subject national opposing locked intensive unskilled court stress time value
screen	much what engaged addresses modern middle elicit earnest concentrated would nationally shetland total contrast go
tube	a politically at claims stress suggestion question engendered as facilities dividing intend identifiable whom we
menu	corollary modern elicit shetland rights determines opposition much role possibility status students again incomers being
mouse	far unskilled commercial actually distinction sharp at society according mcfarlane behind anthony locked specified at
graphic	simple above conducting too public vaguely consensus but allow these also of raised interests we
palette	understand even politically question society behind areas enquiries aspect at networks most facilities a engendered
copyright	demand use economic social benefit big literature alternative right we today disseminate against oil final
shore	experts being accept total what ln emerges section criterion concentrated wish addresses goliath collectivities theme
sunlight	both impact literature faith matters alternative pieces big rural way benefit dispersed run recently development
ocean	run way fieldwork about population approaches issue connection attract books they take their impact final
engine	explain suburbia concentrates authors again papers determines rights application paper section status intrinsic role launched
slice	e.g. ’? nevertheless too general values raised step london council without different experiences clear-cut developed
cone	microelectronics priorities country particular question 1 rhetoric often claims sector ssrc early most avenue hub
fog	nuclear sane faith competition matters impact public criteria encourage was pieces this crichton acquainted alternative
exhaust	stations work really should literature development right immigrants debate medium neglected launched matters etc operate
smoke	refineries development ’, right leisure literature ideology staff activated benefit social these field north part
rain	etc matters literature faith impact rural suburbia fertile industries launched development dispersed recently both take
monitor	expert circulation support collar affect defend changes disruptive locally more truth produced answers bears deserved
shoreline	emerges about section goliath being papers experts determines criterion theme effects authors attract lies students
signal	besides discussions value has anthony felt predominantly ideas rather conflicting liberty nascent at types new
paint	creation wherever studies ideology massive right locally refineries these public under changes ’, chief answer
spray	public also these but very carrying allow health answer ideology above ideologies right consensus another
radius	relations familiar most country older 1 avenue priorities troublemakers panel rhetoric sea microelectronics final hub
shield	officers besides felt locals capital-intensive value various stress when claims has predominantly migration boot intend
dial	handle tradition cast where circulation conflicting types changes local argument immigrants answers meant disruptive stems
snow	matters faith etc impact rural literature fertile industries both dispersed nuclear suburbia recently launched development
fold	another immigrants us local medium tend farms living things mentioned count stems this launched said
basket	aspect incomer politically a question sector claims suggestion at stress enquiries useful particular inhabited meaningful
container	society meaningful at areas enquiries commercial davids politically at question most well-known behind a anthony
skull	provision social in health get almost effectiveness year incomer depends luxury opposing locals unique question
pole	education felt opposition possibility modern stress boot time migration intensive again intend new as court
glass	health yet question also allow very social provision country aspect ssrc high-density an avenue carrying
van	housing two suggestion politically mcfarlane published migration opposition stress apart time subdivided felt networks new
sack	transportation stress dividing its claims series early assuming locals felt boot when before useful communities
tank	facilities intend suggestion politically when networks two at a claims engendered predominantly subdivided its published
concrete	these right also social very ideology another answer allow consensus blue benefit the disseminate during
strand	controlled most familiar avenue panel carry is country relations sea make are older priorities 1
spot	nationally modern much what possibility types would addresses felt engaged prime middle opposition go as
harness	locally changes massive disruptive view stems us local circulation cast medium creation immigrants more produced
branch	most familiar against country aspects final constraining sea alternative relations company avenue make 1 take
blanket	cost commercial meaningful division at actually number davids enquiries unskilled at neighbourhoods society areas few
chair	effectiveness polarity redundant incomer two expediency provision almost this terms depends expanding suggestion published are
electronics	demands science activated north others rationalisations jackson jobs anthropological larger leisure rural right groups urban
stick	decisions deserved defend affect circulation bears our support presented dispute collar changes of planning parts
turf	equally industries papers approaches about attract take become alternative section launched run fieldwork determines possibility
column	vital aspects series its take encourage alternative postgraduate these company dividing when claims pieces big
log	location commercial at cost well-known society at areas nascent anthony davids meaningful behind enquiries conflict
batter	things us another immigrants locally medium local produced disruptive stems topic living provide circulation more
batch	clear-cut raised nevertheless london council too e.g. ’? values compare carry avenue different is (something
pencil	sphere whether sorts comparatively growth agriculturally attributes grew that possible explicit commitment yet deliberately do
pad	subject actually migration unskilled court 171 stress opposing case predominantly does ultimately currently distinction between
one-half	controversy compare panel oil social carry observed journal connected given pahl economic we an today
numeral	achieving such at politically doing saunders commercial extensive whom facilities born course areas engendered society
thumb	goals unemployment immigration arrived have industrial 385 on prevailing communities takes all international south central
pie	struggle receive northwards clearly demarcated into belong another supposed made according far but sphere deliberately
lunch	obvious sea individuals away expressed bring residence thus demarcated suggestive taking understanding organs amount answered
anchor	can work services royal launched perhaps see possibility knowledge this found motivations goliath medium immigrants
gear	expect literature ideology another north faith rural point native right social fertile disseminate ’, in
chicken	receive northwards demarcated into ideologies struggle but clearly another north ideology staff surprisingly rationalisations dairy
cigarette	equal grew possible divide schooling attributes comparatively sorts agriculturally protect tended it commitment gives cases
arrow	treatment with royal important find none policed companies anchored dominant some explain however background david
box	politically suggestion at a facilities two intend claims stress opposition engendered new subdivided apart predominantly
soldier	numbers since race class combined completed correspondingly each consideration grew agriculturally situated commercial behaviour how
string	too general raised e.g. (something nevertheless perceived interests different above experiences objective london avenue major
desktop	small conflict does right ideology intensive either time tel possibility looking in point listen value
cabin	count concerning farms centralisation denied this forum latter mentioned launched competition mentality category was same
valve	majority at unskilled commercial anthony distinction actually predominantly far sharp society politically extensive areas engendered
deck	concentrated total accept what much earnest engaged wish addresses experts ln elicit being criterion papers
laptop	cheaper explicit demarcated receive does surprisingly then dairy but constraint bracket whether deluxe according far
debris	attempts development benefit like literature rural books final field today events listen recently right economic
toe	uniform stems view locally produced cast where meant disruptive professionals local types changes living sponsored
kitchen	centralisation farms appeared forum latter where same so base count mentality mentioned focussing competition concerning
smile	schooling tended exclusive passing second boom possible divide cases equal grew protect sorts those it
bicycle	gives consider choose applies cost grew that vested actually division attributes number protect vicinity whether
fork	rise understanding growth constraint whether sphere that grew yet commitment choose according attributes explicit actually
camera	migration predominantly 171 stress opposition felt actually suggestion two politically case between value distinction as
cupboard	isolated crichton expanding competition published expediency this was acquainted forum meaning suggestion dichotomous processes base
glare	so uniqueness lies population concept body life contained fieldwork about constraining servants phrase books dividing
sewing	arises receive taking show rationalisations north jackson word oil position factors ’, attitudes leisure had
pen	whether sphere actually grew division cost that be agriculturally far according attributes commitment depends choose
strip	afford (something avenue hub perceived way liberty priorities older rhetoric 1 most ssrc country high-density
torso	luxury provision get in edinburgh on opposing social conditions prevailing all depends almost national effectiveness
cardboard	giving above do but in sciences of industry simple sphere within panel conducting too public
cartoon	remote economy few industry at bell meaningful commercial davids study course inhabited co-operation agriculturally there
finger	does gives grow choose residents mercenary have vicinity unemployment traits consider almost explicit 385 vested
bulb	win owned politically suggestion at published facilities belonging between intend subdivided two a extensive predominantly
fountain	grounds at politically question a aspect society commercial claims sector anthony areas doing mcfarlane most
seating	questions native fertile rural right names literature listen part leisure matters activated development ideology jackson
tennis	answered reputation another allow reports sciences vaguely these ideology north surprisingly social jackson rationalisations but
bedroom	terms origins count this competition instances concerning crichton expanding said effectiveness farms polarity isolated motivations
drawer	expediency isolated incomer crichton expanding this suggestion competition published two acquainted politically was subdivided encourage
lift	where cast circulation tradition stems conflicting types meant answers ideas besides local living nascent discussions
wrist	stand phase wide-ranging 385 unemployment arrived myth thought industrial talking masters definable promote central determine
forearm	councils stand unemployment wide-ranging 385 grow prevailing phase thought international lie argue so-called residents all
bone	answer right social these also in ideology very another allow health against benefit alternative field
ball	rights incomers role wider this authors theme application students debating section forum again elicit category
blade	minority claims dividing stress a early communities locals tends its objections various politically assuming debating
foil	organs ideology right really point creation behind demarcated another these native conflict wherever simply in
compartment	crude forum again category concerning sites application competition rights same debating students so denied crichton
cuff	deal added servants possibility edinburgh in authors opposing papers polarity stress 1971 unique explain social
pump	conflicting cast types besides value where felt discussions living meant large ideas stems influences divides
tights	myriad activities socialising aim jobs who encouraged seen ambrose had welcome oil urban create problems
plaque	anthropologists at commercial number at relation course belonging ultimately has nascent born economy anthony race
plug	tend external living published another expanding us motivations stems immigrants types this intend sponsored local
pouch	regard effectiveness in provision depends (1 get opposing almost facts incomer redundant two social actually
mural	viewpoint economy at commercial consideration may remote course race numbers few behaviour since meaningful bell
foam	events literature benefit development rural alternative attempts field books faith take big final matters recently
marker	outside there few davids different study well-known most communication doing priorities rhetoric may commercial often
meter	influences at predominantly migration 171 value distinction felt anthony politically intend besides division suggestion opposition
cream	known receive ’, urban north leisure welcome rationalisations activated native negotiation dairy jobs had separation
breakfast	individuals obvious sea away demarcated jackson oil receive reports answered taking expect north struggle ideology
ingredient	always research which form essentially are or encourage dominant royal its with vital common acquainted
wayside	danger real debate section application classification this authors sited held other work connection suburbia fundamental
triangle	study often few priorities rhetoric davids perceived ssrc most co-operation inhabited enquiries there high-density hub
bacon	problems who aim seen everyone had welcome jobs others activities urban activated encouraged niceties permanent
signature	unique there situation doubtless year early uniqueness locals its contained social objections assumption servants aspects
quilt	themselves cost stress unskilled actually at extensive sector owned case sharp a migration distinction commercial
bite	our dispute decisions involved residence where suggestive am understanding deserved tradition characterised bring nascent circulation
kettle	present much what earnest middle engaged total concentrated elicit addresses would contrast go sentiment modern
powder	show rationalisations ’, north urban jackson activated leisure public receive these another position ideology jobs
coil	false aspects take question assuming claims whom vital when tel a series useful early its
tip	uniqueness concept so about justified constraining contained examine population servants fieldwork five there books effects
painting	allow also social another health right these very our the question ideology seminar disseminate answer
mast	perhaps authors work launched servants goliath possibility claimed section again students boot this suburbia role
carving	even question allow health understand tel also very most carrying assuming high-density spokesman the blue
pew	dichotomous isolated crichton competition expanding expediency acquainted this was published suggestion forum polarity processes base
speaker	ideals role assumption boot debating wider students when 1971 rights again its communities actual various
tin	above too interests industry general (something bell few perceived health community within meaningful enquiries avenue
rag	reflections cost at commercial agriculturally grew each class comparatively temporary numbers consideration race bureaucratic division
battalion	attempt most familiar priorities troublemakers avenue rhetoric country company particular dividing claims make hub tends
booklet	cover has networks saunders adopted claims predominantly areas at commercial engendered doing such politically essentially
toothpaste	ways ’, merely together leisure conducting staff consensus activated observed jackson during social like oil-related
sausage	made receive belong struggle deliberately sphere but factors northwards supposed clearly seen according who whether
notebook	explicit choose whether mercenary that sphere over all effectiveness vicinity yet immigration attributes be depends
yard	forum competition again so mentioned same centralisation concerning crichton denied category was rights application claimed
shirt	takes immigration term choose have entire vicinity mercenary all springing on lie explicit unemployment south
monkey	each commercial race distinction since sharp completed at numbers situated behaviour agriculturally how class consideration
hair	side determine industrial defined unemployment stand create masters arrived talking have air-traffic south 385 local
hat	choose have vicinity immigration mercenary gives explicit term yet whether takes that all springing sorts
wording	issue their books justified (june body examine population run fieldwork final concept any phrase make
vest	over explicit sphere choose mercenary that whether redundant springing yet attributes reports rise bearers sciences
rein	precisely changes stems where locally view involved circulation sponsored am one deserved dispute understanding cast
tide	disagreement about population effects uniqueness concept students dividing politicians sustained there fieldwork papers assumption past
sink	us another medium local farms immigrants topic things tend (and provide count living centralisation locally
tail	get in opposing social provision right question social varied ago postgraduate take national time answer
statue	rhetoric priorities hub perceived avenue ssrc major older often few different (something particular country familiar
license	of parts decisions circulation deserved expert our collar affect one support dispute where defend answers
vase	course inhabited meaningful co-operation at commercial enquiries davids bell at few society number aspect cost
elephant	find with treatment dominant instance referents none background important royal close concerned however some form
referee	real rights suburbia debate concentrates role capital-intensive this section context authors application explain sited wider
slab	objective perceived rhetoric general major too interests different few priorities (something hub ssrc often study
reflector	aims at grew agriculturally comparatively class although economy each consideration commercial far bureaucratic according may
hinge	sordid middle earnest whole engaged sentiment much what necessarily internal little nationally enquiry developments go
cap	mercenary vicinity all depends choose (1 immigration on actually almost effectiveness explicit that whether division
bulge	processes this crichton was competition category forum are encourage intend again expanding denied claimed when
cooler	examined audience another north demarcated expect receive point placed struggle ideology groups urban rationalisations word
gray	forms faith rural in north fertile another get dairy said indeed groups position native aware
envelope	important royal treatment none policed companies explain anchored david impact again some forum category concerning
hydrogen	component special merely activated ’, jackson leisure consensus science others urban like during rationalisations larger
chimney	statements again regularly occupational 1978 debating interest rights communities stress wider sites category authors boot
mud	faith matters rural literature impact fertile both nuclear development recently dispersed etc listen said sane
apron	logically have air-traffic south taking springing stand masters kin traditional administrative 385 choose arrived conditions
dome	sustained dividing tends population concept effects take assumption constraining communities troublemakers informed uniqueness series debating
fan	examination few industry at bell economy authority commercial cost agriculturally davids within meaningful division neighbourhoods
mesh	will simply against alternative series assuming spokesman postgraduate most question aspects useful also transportation big
shoulder	persuasion stand thought myth phase wide-ranging 385 so-called unemployment residents promote councils central talking definable
shoe	facts actually be vested redundant subject cost behind surprisingly effectiveness unskilled aspect into almost anthony
pocket	touchstone international lie talking unemployment grow prevailing central 385 industrial arrived along immigration thought masters
bat	discussion actually distinction migration case value anthony unskilled mcfarlane 171 constraint stress predominantly felt behind
giraffe	i cases second possible socially agriculturally temporary comparatively articles numbers grew schooling those class although
deer	assume ideology north right another sake leisure these in our point hoped separation native social
owl	loose background treatment non-technical dominant find explain royal with important anchored should companies close none
eagle	non-technical find treatment with background dominant none close instance referents important however royal institutions concerned
antelope	sense larger activated welcome had leisure aim others urban north negotiation rationalisations ’, separation like
limb	denoting also the question allow very assuming most health blue vested high-density right these answer
jaw	prevailing central arrived unemployment provision promote almost luxury argue effectiveness all international on talking patterns
tunnel	debating again students rights dividing wider authors category role actual communities its forum sites sited
barn	exact published suggestion this expanding motivations subdivided when two intend politically new facilities crichton category
fur	aware get in another native placed on blue social staff conditions ambrose health facts then
ledge	vagueness number ultimately whole forge born would as court socio-economic go modern anthropologists at owned
abrasion	fact dichotomy activities others jackson special aim fields encouraged welcome science had ’, wherever vaguely
cow	notion commercial each distinction agriculturally sharp far completed actually cost era class at residence since
rib	perhaps well-known commercial most davids within high-density economy anthony society far cost at meaningful there
switch	answers circulation where cast changes support types defend meant collar affect topic around conflicting stems
cliff	2 effects again assuming early stress 1978 before regularly dividing communities shetland tends incomers debating
kite	bureaucratic class race each sharp commercial distinction grew although numbers behaviour consideration spreading situated outline
gull	ideology commercial may at at most economy doing davids although sharp race anthony 1968 study
mask	division actually cost commercial distinction anthony case few neighbourhoods well-known davids era doing at sharp
calendar	dunrossness students paper again section papers launched debating rights determines boot authors forum possibility claimed
scaffolding	graham the right also listen these benefit literature alternative ideology very development simply rural time
truck	mcfarlane unskilled housing distinction case at apart actually politically anthony stress extensive two a commercial
crane	outline class race unskilled commercial distinction sharp consideration at actually far correspondingly grew broader agriculturally
cabbage	factors who seen ribbon belong receive supposed position everyone had problems rationalisations welcome aim struggle
contemplation	given carry observed connected panel is we journal not compare social benefit use economic big
stall	division migration case published belonging politically 171 two at distinction actually suggestion as motivations owned
fence	incomers rights role theme this elicit authors again papers section determines application sited being goliath
wallpaper	native rural right literature listen fertile ideology development in matters part faith placed names social
decoration	during right merely economic like benefit social consensus leisure today these activated also use jackson
brook	first again debating wider category boot role communities effects authors dividing sites launched section when
elbow	phase stand so-called wide-ranging no myth promote 385 unemployment arrived masters persuasion thought ease argue
heel	so-called phase no stand ease argue conditions residents promote 385 myth arrived unemployment example wide-ranging
baby	era distinction sharp anthony actually case extensive commercial predominantly how migration at unskilled mcfarlane owned
lawn	shetland elicit again papers theme incomers determines much modern rights role being addresses corollary 1978
sky	focussing held same section connection latter application suburbia concentrates centralisation forum appeared dispersal goliath authors
urn	touching royal anchored explain impact treatment take important policed again sites launched background they authors
toddler	professional possible sphere agriculturally sorts grew comparatively class growth numbers whether commitment attributes that according
bench	middle earnest what much would addresses contrast engaged total go sentiment elicit modern whole forge
photographer	class race numbers correspondingly since consideration outline commercial combined distinction grew completed sharp at each
lip	migrants definable stand industrial myth talking thought wide-ranging basic determine promote masters suddenness local 385
restaurant	(see belonging published expanding motivations areas occupations at two suggestion politically subdivided division apart networks
accountant	instance with find referents treatment none concerned important dominant royal some before david remains settlement
leather	ambrose but position north do rationalisations another receive aware clearly existing show reports blue sphere
heater	1974 opposition intend facilities again predominantly status politically suggestion born possibility felt published boot migration
mirror	crichton competition was isolated this forum expanding processes base meaning so published where acquainted encourage
tag	1964 divides early nationally objections claims anthony felt stress politically such engendered doing has predominantly
goggles	forsythe others activated north permanent fertile leisure native welcome urban jackson negotiation jobs names expect
speculator	harris predominantly migration extensive opposition camps value unskilled stress various politically identifiable as engendered 171
appliance	newby dominant with of royal form should treatment explain background find anchored aspects tel some
garlic	1977 who everyone aim welcome jobs problems had niceties urban others encouraged activities seen activated
jar	bell industry meaningful few enquiries at inhabited course davids community agriculturally co-operation study economy society
bubble	rose question claims anthony well-known networks stress in high-density transportation tel assuming doing most also
movie	saunders doing at commercial networks politically anthony distinction areas has claims essentially extensive sharp engendered
curtain	1978 regularly rights wider debating interest shetland occupational again stress 2 role statements incomers 1971
narration	pahl we journal carry economic panel social sea compare not observed familiar books connected benefit
bell	1965 rights opposition role capital-intensive incomers status again category corollary modern debating felt 1978 context
hoof	some much engaged go shetland modern what addresses would early court possibility papers middle prime
moon	concentrates section held suburbia papers rights incomers role focussing authors goliath criterion this determines application
stain	socio-economic number go ultimately vested the early whole court subject born enquiry as forge modern
garment	engendered predominantly anthony politically at claims a has facilities stress its suggestion networks whom intend
jacket	immigration takes vicinity choose have mercenary all unemployment term lie entire springing on international explicit
homo	complete economic social right ideology aspects neglected we literature benefit use development in big also
bow	understanding constraint dispute discussion residence cast where actually division nascent females attitudes whether suggestive characterised
pipe	depends all actually vicinity mercenary (1 case provision effectiveness division subject almost opposing on unskilled
poster	broader commercial sharp distinction at areas race actually at communication saunders unskilled cost owned consideration
logo	perspective court corollary status 358 modern opposition elicit shetland camps much possibility kind predominantly incomers
rack	ultimately born as politically court number would migration at early stress opposition modern intensive forge
apartment	origins instances terms this crichton motivations count competition expanding are processes effectiveness was concerning said
briefcase	lie international grow unemployment immigration touchstone explicit all mercenary vicinity 385 feeling talking choose takes
napkin	interaction divide choose explicit grew it term attributes whether does vicinity mercenary sorts immigration traits
wallet	international lie touchstone all unemployment grow immigration prevailing mercenary vicinity depends feeling explicit talking (1
cargo	purposes against most social also right question today health benefit familiar avenue alternative very an
cable	looking conflict value question point behind when stress migration anthony networks tel time well-known a
brake	internal whole much nationally middle court large what as earnest go engaged present modern intensive
star	doing well-known anthony claims commercial saunders at most davids particular question politically areas there has
leap	am involved where stems circulation deserved cast our understanding tradition living nascent appropriate changes characterised
rider	only actually migration felt national value distinction capital-intensive predominantly locals opposing imputing stress various anthony
racket	going at politically anthony saunders networks distinction actually areas two suggestion predominantly commercial engendered apart
stereo	bracket conflict does surprisingly unskilled subject opposing into looking locked migration far receive northwards facts
disk	off does ideology placed right locked conflict surprisingly than also point looking the intensive subject
slot	external published expanding tend motivations suggestion two this facilities intend apart politically (see new scene
socket	scene suggestion politically migration 171 predominantly opposition again intend published apart new a varied two
mailbox	do besides divides predominantly influences value distinction has actually 171 felt discussions born migration anthony
pond	intend facilities suggestion when again new politically this category opposition boot published felt two motivations
sleeve	argue no central ease prevailing almost on provision conditions unemployment promote patterns year could arrived
cord	analysis explain suburbia again authors status concentrates application incomers sites intrinsic rights 358 shetland papers
flap	before stress again dividing possibility communities 2 category 1978 series its early opposition politically felt
duct	begin explain suburbia application sites criteria they take launched concentrates again sited paper authors national
rim	examine justified about population uniqueness their issue attract person body concept five approaches politicians life
pat	little applies sordid whole vagueness attachment internal socio-economic around gives consider number ultimately forge middle
egg	background dominant treatment find royal important should explain does national close point ideology in right
juice	information ’, leisure activated merely together staff consensus like oil-related jackson part urban development conducting
hay	part literature development benefit rural leisure like right activated ’, attempts faith staff social matters
gram	expected of in ’? step e.g. without general values too (7 villages fishermen experiences above
stocking	bear allow reports another to sciences disseminate ideology taking social behind these but redundant facts
calf	immediate actually far unskilled that cost case behind era facts mcfarlane redundant distinction whether according
knob	changes court modern opposition much shetland corollary elicit kind go possibility would status 358 migration
lining	relating regularly interest occupational statements politicians people suburbia wider 1978 1971 fieldwork crofting servants section
groove	zone again sites debating forum boot rights when take category authors intend new communities determines
turkey	demarcated receive does into northwards locked far dairy national unskilled ideology surprisingly migration camps behind
hook	administration types felt as opposition character would modern possibility born large court 171 nationally migration
shovel	growth grew sphere commitment according attributes comparatively that agriculturally whether yet far constraint amount sorts
thorax	potential final take become books big benefit aspects run alternative literature fieldwork way industries rural
abdomen	problem matters faith rural fertile impact suburbia industries etc launched said take in literature potential
float	changes circulation locally collar answers where affect deserved stems support cast disruptive produced defend more
bumper	identified industry authority suggestive residence examination at economy agriculturally few appropriate consideration division comparatively villages
brow	thought talking stand wide-ranging industrial unemployment central 385 myth promote definable prevailing persuasion arrived lie
dash	suggestive residence nascent division appropriate authority well-known understanding afford besides at was constraint anthony where
garbage	might social economic benefit literature use alternative we big development today why disseminate the public
tablet	place commercial at davids meaningful at society economy few most correspondingly cost agriculturally appropriate areas
steam	construction these right also social consensus ideology allow ’, very answer refineries another merely staff
locomotive	winds right tel point take when in aspects alternative these locals vital social the explain
steeple	down question assuming communities early take stress sector a whom claims various tel microelectronics politically
raft	production few davids enquiries priorities most inhabited co-operation rhetoric course meaningful ssrc high-density doing often
sofa	earnest middle sentiment what much total concentrated engaged addresses accept contrast elicit ln present among
broom	date grew comparatively agriculturally attributes commitment sphere at according cost far meaningful growth that whether
passenger	received two published housing time subdivided suggestion apart behind migration camps motivations politically as redundant
shutter	largest national 358 status camps explain suburbia again does added shetland authors time migration criteria
pillow	proportion court earnest forge elicit middle much addresses go shetland contrast whole would what status
feeder	young redundant behind point based (see published another reports external sciences long expanding motivations belonging
vent	professionals circulation where topic produced disruptive stems meant local cast answers locally us support types
sill	associated total accept elicit wish papers criterion addresses theme concentrated determines incomers being shetland goliath
conductor	various claims capital-intensive stress locals when dividing extensive communities its predominantly a felt 1971 minority
peel	oil-rig massive locally creation provide changes broken disruptive weapon medium immigrants more wherever us council
exit	servicing other goliath authors work criterion see this section royal servants wider being explain rights
microwave	based published isolated expanding (see networks suggestion behind expediency two subdivided facilities belonging redundant politically
comb	airport constraint whether understanding division actually that grew era attributes commitment subject distinction residence according
helium	overwhelming economic use special wherever right oil literature social these instruction social development ’, benefit
lock	immigrants another medium farms time local us possibility types boot living this motivations count suburbia
guy	pilots how combined distinction completed dr saunders predominantly has council sharp cover adopted employer era
frisbee	engineers institution possible growth professional sorts grew schooling bring comparatively amount second residence class tended
skirt	air-traffic taking administrative south logically ambiguity have refute springing socialising be contrasted it side yet
baseball	controllers sphere sorts growth possible belong comparatively do but professional deliberately grew agriculturally amount according
blouse	administrative air-traffic ambiguity south taking logically have socialising side it pursued defined distinct sorts springing
soup	staff ’, leisure social right benefit literature these during consensus ideology development also part in
sunset	increased work again before authors end intrinsic goliath perhaps sites possibility neighbourhood 358 claimed incomers
flag	1971 role debating wider rights students servants boot category again authors possibility 1978 communities situation
cube	(march question most early claims assuming microelectronics country particular tends familiar aspects dividing whom 1
intersection	(june body issue life while their phrase justified fieldwork books so population examine run uniqueness
pavement	total accept wish what concentrated among addresses ln earnest experts elicit being much criterion theme
tray	number cost vested ultimately owned course at case at aspect politically socio-economic unskilled vagueness commercial
knot	inhabited co-operation few course meaningful enquiries often davids bell ssrc industry priorities aspect study commercial
cornice	dwellings explain various authors again effects 1971 concentrates role national before stress application 1978 intrinsic
thigh	385 stand unemployment promote arrived residents thought talking wide-ranging industrial central masters prevailing phase immigration
spectator	1968 commercial at anthony doing well-known correspondingly saunders distinction davids communication has sharp completed engendered
petal	541 few avenue (something high-density perceived afford rhetoric priorities study interests too davids hub there
ivy	increase negotiation development native rural events relative literature fertile part faith indeed larger placed matters
bud	housing acquainted isolated crichton competition expanding expediency encourage was dichotomous published this base processes meaning
cup	workers ’? e.g. step general nevertheless values too without (7 council raised experiences london of
wreath	considered consideration temporary those at race bell examination numbers cases grew agriculturally industry commercial class
vine	critical assuming early take stress tel time possibility the alternative intensive 2 shetland enquiry series
waist	suddenness arrived basic stand phase wide-ranging masters promote conditions local unworthy no unemployment defined 385
stadium	necessitated forum expanding crichton again this found category published intend competition motivations suggestion was when
edging	policies royal living should time in immigrants ideology social one right to operate local stems
partition	constraining final books uniqueness concept most against take make sustained population contained aspects alternative fieldwork
roadway	dispersal section being rights goliath same theme students connection authors papers determines again criterion this
gutter	concentration base appeared centralisation where so centre forum competition was crichton room mentioned latter meaning
fixture	direction consideration at correspondingly belonging 1968 commercial (see course race inhabited broader at anthropologists saunders
carrot	northwards receive into clearly demarcated far unskilled locked another actually surprisingly ideology ideologies according struggle
helmet	vicinity all mercenary depends choose immigration (1 on actually term gives almost case takes whether
hip	traditional conditions arrived 385 facts on almost unemployment taking have so-called stand mercenary south luxury
umpire	settlement real royal imputing debate explain capital-intensive time felt types suburbia found value medium boot
pedestrian	pattern within cost agriculturally economy well-known at commercial examination davids merchants meaningful industry bell society
trunk	varied stress suggestion again politically when claims communities assuming locals series a take new intend
carton	developed general too e.g. above few experiences objective different interests industry because perceived bell community
droppings	topographical development rural literature attempts like faith anthropological fertile recently leisure part activated matters benefit
brush	constraint understanding discussion attitudes actually whether according division cast unskilled subject residence far airport distinction
palm	patterns central social conditions however provision arrived prevailing masters ease promote in contained health argue
berry	land cases socially each agriculturally second bureaucratic temporary consideration at those comparatively although aims numbers
cactus	tenure at unskilled commercial far sharp extensive society areas politically actually most a owned identifiable
pear	exigencies deliberately struggle sphere northwards receive clearly but far according here existing agriculturally another within
pigeon	agriculture commercial far agriculturally sharp distinction at cost areas meaningful actually economy society broader each
mango	original had decisions who seen estates rationalisations aim factors encouraged expansion belong receive but conducting
hood	added stress currently 1978 court before opposing migration recent shetland 358 statements 2 1971 national
coconut	estates rationalisations conducting had but receive vaguely ’, consensus decisions show activated leisure urban welcome
pitcher	(both number meaningful commercial ultimately enquiries at cost stress unskilled vested well-known grounds aspect actually
splash	authority industry examination few bell meaningful at within general in suggestive experiences economy too above
candle	owned case distinction at sharp actually commercial politically division unskilled extensive era mcfarlane number cost
cucumber	ribbon who factors seen everyone permanent problems supposed belong niceties aim great high-risk moreover receive
pepper	privately who permanent everyone ribbon problems 1977 factors seen myriad aim alterations bust niceties differences
bamboo	deluxe but public receive ideologies blue carrying consensus these also rationalisations another very placed into
spice	chief creation wherever right three oil answer ideology these against social refineries use literature development
chef	employer distinction extensive anthony actually sharp predominantly at migration various identifiable doing felt era advice
rod	recent stress migration predominantly opposition 171 various felt politically suggestion between as a extensive court
emblem	figures sea troublemakers books familiar final most concept or doubtless respectability five uniqueness make sustained
groom	council national north ideology right massive does in northwards imputing edinburgh demarcated get native luxury
pastry	529 literature native ideology rural right events development listen part faith in placed fertile social
strap	currently stress added court migration subject felt early modern before opposition shetland transportation predominantly time
liner	employed at politically extensive predominantly a engendered stress identifiable as migration felt suggestion opposition anthony
piano	358 status possibility elicit opposition modern again camps shetland time corollary court migration national does
microphone	171 migration predominantly opposition politically distinction suggestion between helped stress case felt at two division
seam	natives early dividing claims its tends assuming objections minority series assumption stress a 2 particular
color	represents activated together like merely leisure during had aim consensus conducting ’, others attempts accompanied
trim	massive locally creation changes studies wherever understanding disruptive view ideology point more right immigrants provide
pearl	expansion rationalisations but receive conducting ambrose show position vaguely consensus urban north public had estates
bacillus	labour we when these claims processes opposition dividing communities essentially series its politically again debating
parachute	force gives mercenary actually whether that choose division cost understanding vicinity grew all depends residence
jet	totalled well-known economy there question most commercial doing davids within few production meaningful society cost
slit	9 suggestion published expanding intend two politically new opposition facilities 171 migration category as motivations
streak	(7 general experiences too in few e.g. interests industry because of ’? developed nevertheless above
cylinder	whom claims early question a politically engendered particular at stress most sector assuming anthony facilities
nozzle	classified dividing again debating sites communities its claims take tends various when a sustained series
vane	shetlanders early politically before whom a assuming question stress communities again suggestion engendered at claims
tractor	unskilled actually mcfarlane distinction migration far case sharp at extensive stress predominantly locked commercial subject
tungsten	semi-skilled but within above clearly do far receive northwards according sphere public agriculturally ideologies community
marble	blue these also very another allow carrying the right health separation placed answer social consensus
sail	collar circulation deserved changes support affect expert defend answers produced where locally decisions more stems
center	while body (june life so justified population issue fieldwork uniqueness lies phrase examine concept about
pillar	hub rhetoric priorities perceived ssrc major older avenue often few (something country particular familiar afford
booth	still politically published suggestion expanding category opposition new again two 171 intend forum isolated crichton
nail	long published redundant migration as ultimately behind division time born two motivations subject intensive for
dirt	fertile matters faith rural listen industries etc development literature dispersed recently impact problem suburbia native
shower	agriculturally at meaningful industry bell comparatively consideration grew cost commercial economy each attributes far society
toast	productive ’, leisure these staff conducting separation consensus oil jackson graham ideology also public creation
battery	most davids question commercial doing well-known particular anthony high-density enquiries at often there priorities society
transformer	agricultural at commercial distinction anthony correspondingly may influences sharp communication broader has at saunders 1968
barrel	sector question a aspect particular claims politically stress enquiries at priorities most davids microelectronics whom
tongs	part-time permanent welcome negotiation relative increase saw niceties forsythe everyone others urban jobs great progress
topping	crofting relating regularly interest occupational statements narrow people politicians suburbia fieldwork immigrants tel 1978 what
silhouette	unusual priorities company ssrc yet rhetoric country particular avenue incomer question hub often most essentially
bin	tracts isolated crichton expanding competition published was forum meaning base this processes acquainted concentration so
diamond	sufficiently agriculturally economy comparatively within at contrasted industry examination although bell meaningful grew commercial cost
dragon	extensive sharp distinction at politically predominantly identifiable various a claims stress migration commercial anthony saunders
latch	full-time what experts much topic concentrated ln addresses engaged prime nationally among accept total earnest
chandelier	farming debating communities 1971 capital-intensive role felt again opposition we dividing 1978 category application stress
sauce	dairy demarcated receive into indeed native ideology does another national northwards placed surprisingly staff groups
bathroom	farms centralisation count forum mentality same concerning where so competition meaning appeared mentioned latter suburbia
jam	word receive north ’, jobs rationalisations dairy welcome another urban show who everyone leisure position
hallway	appeared centralisation latter room so base forum mentioned same focussing concentration where farms connection held
beard	term takes choose immigration vicinity all mercenary yet sorts divide entire explicit have whether sphere
guitar	surprisingly actually unskilled into subject does facts opposing conflict migration locked far anthony predominantly cost
knee	residents 385 does so-called grow mercenary choose gives stand phase unemployment have vicinity immigration lie
porch	same forum focussing section centralisation so application latter held authors connection dispersal suburbia again goliath
beet	scientists then ’, urban welcome progress distinguishable everyone jackson others leisure jobs wherever activated had
jug	community industry meaningful bell above general enquiries within few agriculturally at davids society study cost
ramp	occupational regularly interest wider statements 1978 rights being prime image role again incomers possibility probably
dryer	referent unskilled distinction far era actually sharp predominantly 171 locked migration upon subject owned case
lap	example myth masters promote stand ease phase so-called wide-ranging 385 thought talking along central local
wheelchair	pilot comparatively agriculturally composed grew attributes (see exclusive industry numbers at appropriate protect sphere possible
pan	refer politically at suggestion society meaningful belonging aspect a facilities apart areas subdivided (see behind
riverbank	collectivities total experts being criterion what accept emerges ln goliath determines addresses section concentrated elicit
dais	supposedly elicit modern addresses what middle would contrast much nationally whole court status shetland forge
gown	distinct south air-traffic have taking springing logically choose administrative entire immigration yet it unemployment side
soap	shetlander another these ’, rationalisations north urban receive leisure right activated staff ideology also allow
sociable	churchgoing belong turn moreover factors who supposed seen ribbon ambiguity bring comment made sphere closest
cage	incomer aspect are suggestion expediency politically two this essentially effectiveness useful yet company redundant subdivided
rainbow	geographical priorities rhetoric perceived avenue older ssrc different familiar hub major country often (something relations
arch	anchored royal explain they authors papers take there launched servants debating students about assumption again
teddy	space grew comparatively agriculturally second cases each consideration at residence possible numbers claim class since
beak	members get ago be explicit health question but cost facts aware incomer whether division carrying
lemon	live had who seen aim welcome urban jobs high-risk encouraged everyone factors rationalisations negotiation problems
spike	least nascent ultimately anthony at cost born commercial vested actually number behind politically distinction well-known
sculpture	vaguely merely allow conducting consensus these rationalisations activated another during right leisure ’, science also
chin	definable stand thought myth talking wide-ranging unemployment industrial 385 defined phase determine persuasion side example
buttocks	defined side create stand arrived unemployment definable 385 masters socialising industrial local determine talking wide-ranging
doorway	base centre where crichton concentration centralisation appeared competition so forum was meaning same latter isolated
thunderbolt	socially second cases temporary those numbers articles i grew schooling passing comparatively tended class although
bull	identifiable stress politically a at claims extensive felt suggestion anthony new predominantly opposition various as
jockey	collectivity actually distinction employer only case anthony communication migration era imputing correspondingly advice felt combined
wrap	numerous decisions defend planning deserved affect changes circulation bears science presented weapon support more is
athlete	referents find instance with dominant institutions concerned remains treatment system before close background royal form
stump	narrow regularly stress administration 2 objections felt early occupational possibility locals statements 1978 interest assuming
foreground	centre base where was competition crichton so centralisation meaning concentration appeared encourage forum latter farms
glaze	characteristics public cost but constraint ideologies according behind carrying division receive into within far understanding
tripod	eyes possible protect sorts grew growth gives schooling deliberately sphere comparatively agriculturally equal amount examination
knuckle	discover characterised circulation males where changes collar cast deserved who support local living professionals answers
tent	suggestion politically two intend published this facilities new category motivations expanding subdivided opposition a when
sandal	constituting health vested carrying facts blue south aspect scale be logically social taking high-density public
padding	relevant development literature fertile events rural listen matters attempts benefit faith equally field etc industries
bucket	meaningful industry bell society enquiries at inhabited davids cost course few agriculturally commercial community co-operation
brace	villages too general in few e.g. because industry of experiences authority way raised (something assimilated
artwork	hamlets industries become equally about run take books final fieldwork approaches literature there paper papers
badge	neighbourhoods cost commercial davids few vested doing high-density division number most production there well-known enquiries
dad	attributed determine side unemployment have membership individuals forsythe springing socialising international moreover goals immigration defined
stove	status elicit incomers rights again role shetland theme modern opposition application criterion possibility goliath being
blond	they referent forms airport constraint then self-control all aware term luxury indeed on vicinity mercenary
cafe	belonging (see published at politically expanding suggestion motivations subdivided apart division two areas occupations saunders
saddle	said competition farms was instances mentioned centralisation count impact forum so latter this denied crichton
syrup	distinguishable another dairy rural faith receive ’, then expect north placed jobs groups progress urban
singlet	dialect health on all but depends mercenary vicinity above industry provision carrying whether sciences cost
pea	less above but too simple do industry ideologies clearly within general allow public conducting in
oven	(and where farms centralisation was forum crichton count base meaning so concerning this competition centre
gauze	humorously very also health blue these public carrying benefit answer an right simply we separation
affray	difference conducting observed simple dichotomy together merely larger consensus special vaguely fields activities during encouraged
galley	mentality centralisation forum farms same suburbia denied latter count concerning focussing so again mentioned application
drum	attitudes actually unskilled constraint case migration discussion subject distinction value far mcfarlane nascent cost stress
dugout	belonging publication expanding this forum category two denied was crichton processes suggestion expediency intend polarity
rooftop	borders would early ultimately modern stress opposition publication forge born education politically go as a
radiator	born politically opposition at as ultimately predominantly forge felt court migration 171 new between two
eyeball	and/or royal about prime of servants work anchored they approaches authors lies launched operate industries
apple	close dominant background find institutions with larger treatment however should none referents royal david important
soccer	reputation social another disseminate these right allow results answered also ideology vaguely jackson merely ’,
plaything	(i.e. different rhetoric priorities hub major perceived older familiar avenue ssrc (something few geographical raised
cowboy	having deliberately numbers agriculturally sphere possible amount comparatively class notion agriculture sorts each that grew
apparel	certain an together activated activities oil others jackson merely observed conducting like leisure special ’,
leash	character modern administration whole would court nationally as much elicit possibility large felt opposition what
stirrup	skills national in time medium opposing get 358 camps imputing migration published motivations really said
claw	beliefs understanding locally where massive constraint dispute cast stems residence changes tradition females am one
salad	belong receive sphere factors struggle who seen made but deliberately convenient supposed do ambrose growth
merchandise	an use economic oil like today benefit social development during merely instruction social right leisure
bedclothes	here share other fundamental concentrates held criterion section this suburbia established same authors papers focussing
limelight	room appeared latter connection centralisation focussing held section same concentration base so forum way dispersal
moss	negotiation activated welcome urban relative jobs leisure ’, had others rationalisations larger encouraged jackson aim
ma	membership tradition gross attributed thus our dispute decisions audience defend residence bring bears creation weapon
towel	attributes grew comparatively commitment that agriculturally cost owned at relates whether actually it case class
shampoo	moreover who belong factors seen supposed ribbon turn show receive made struggle sphere problems rationalisations
pier	criterion goliath section being theme papers determines elicit this authors accept incomers other concentrates dispersal
jeep	denied category forum concerning this again competition mentioned launched claimed count debating rights authors boot
stool	applies ultimately gives forge subject whole number vested as born long vagueness actually socio-economic that
timer	inclusive predominantly 171 felt opposition at migration divides influences has born politically large new value
grate	meaning competition crichton so forum was base farms where centralisation isolated same centre this again
barge	relation anthropologists nascent behind mcfarlane distinction at as for actually anthony felt commercial types location
cockpit	latter centralisation connection appeared section room focussing same way forum held mentioned so launched count
outfield	labelled base where so crichton meaning concentration competition forum centre appeared centralisation isolated was dichotomous
gravy	clarification fertile native rural faith matters dairy literature etc listen names increase questions industries demarcated
cardigan	ambiguity sorts turn closest air-traffic it sphere institution choose yet administrative possible belong springing entire
fireplace	application authors rights section again forum same focussing incomers this connection students role sites category
smuggler	comes numbers since bell at industry each agriculturally temporary course commercial economy few completed study
gelatin	subdivisions jobs everyone welcome niceties activities negotiation wishes urban demands progress 1977 change position encouraged
shaker	dimensions politically subdivided networks housing suggestion when areas at apart point into published a question
footprint	differentiated essentially claims politically facilities a engendered its at has particular whom anthony doing suggestion
mane	scale too e.g. raised nevertheless health london ’? interests despite general council above clear-cut south
spatula	looks possible commitment agriculturally grew consideration second class comparatively amount cases sorts at growth industry
overhang	respectability concept population sustained effects assumption about uniqueness politicians dividing sea approaches tends anchored figures
grease	relative negotiation ’, welcome increase urban jobs larger leisure activated native development jackson part others
spout	permanence where immigrants conflicting regularly occupational cast ideas narrow relating tradition types meant nascent felt
duck	residence suggestive understanding division distinction each commercial agriculturally class at constraint actually grew nascent relation
pebble	relates at commercial sharp grew agriculturally attributes race meaningful owned at broader distinction cost each
stack	(something perceived avenue too older priorities rhetoric interests raised ssrc afford few major hub often
tile	investment these right blue also question ideology allow very answer carrying simply our field in
crate	locality sector davids enquiries aspect priorities at politically question few inhabited a meaningful often ssrc
mushroom	according also public carrying very these ideologies ideology right allow another our but answer blue
mist	criteria again sites take dividing debating launched denied communities suburbia authors competition statements papers forum
doorknob	clearly accept total wish concentrated elicit what among criterion experts theme addresses being goliath ln
cab	apart two suggestion politically published at subdivided motivations facilities migration housing mcfarlane intend opposition belonging
turbine	first at mcfarlane extensive facilities anthony claims unskilled commercial distinction predominantly well-known a migration politically
wagon	camps national migration time opposition 358 stress court as housing predominantly status felt between does
kitten	situated race each sharp commercial numbers class since distinction how although claim era completed combined
goose	(including distinction sharp anthony era actually commercial communication predominantly extensive saunders such broader at how
noodle	camp jobs belong vaguely factors activities sciences who convenient position sphere reports seen niceties quantitatively
beacon	temporary commercial at consideration articles each although race behaviour numbers few reflections agriculturally examination outside
pane	whose constraining sustained tends most dividing assuming company assumption informed uniqueness series concept objections troublemakers
steak	supposed who factors struggle belong seen receive ribbon problems made moreover everyone permanent rationalisations aim
spoon	commitment grew attributes comparatively agriculturally whether growth that according at far class actually cost sphere
puppy	second numbers cases consideration those class each since articles tended grew race schooling claim situated
elf	pass concerned institutions supersaturation referents close find peak before histories type instance identities non-technical system
insignia	through books final issue become benefit fieldwork their contained constraining they examine run equally about
pickle	rigs sphere deliberately possible amount agriculturally belong do receive made struggle clearly according here sciences
manhole	respectable at sharp extensive spreading coincided commercial unskilled politically stress actually a as distinction case
chrome	permanent everyone who problems aim welcome had others niceties ribbon activated urban progress north factors
lace	indeed native dairy placed north position blue ideology increase aware another ambrose receive demarcated separation
ham	seen who aim problems factors ribbon had everyone welcome belong encouraged receive supposed high-risk urban
facade	troublemakers concept familiar sustained most sea doubtless dividing uniqueness tends relations make constraining attempt population
hosiery	amused nuclear sane matters faith impact public literature competition alternative pieces take encourage launched dispersed
alley	policed forum so again mentioned probably important royal debating competition sites occupational anchored denied explain
butt	contained uniqueness fieldwork books informed population constraining there so concept way take final servants sustained
baggage	names in fertile rural literature native development matters listen faith etc part right attempts should
balcony	addresses what much elicit total theme being accept modern criterion contrast would shetland concentrated goliath
driveway	mentioned forum so centralisation again denied competition appeared same latter was section probably category connection
toaster	press migration 171 extensive predominantly unskilled stress helped housing camps mcfarlane distinction various between politically
mattress	court forge modern opposition would shetland go much between elicit whole migration status stress kind
biscuit	cases possible second those agriculturally tended i numbers grew consideration passing schooling socially exclusive crofters
dough	evidence transportation assuming series take question a stress politically suggestion claims tel its dividing again
handkerchief	divide interaction it equal schooling grew choose explicit sorts term attributes commitment gives tended comparatively
cauliflower	i.e. receive struggle belong factors northwards clearly convenient made deliberately according sphere seen but supposed
daisy	reside numbers consideration class at race commercial each temporary agriculturally although behaviour comparatively bureaucratic grew
boulder	applied cost at commercial examination number davids broader meaningful neighbourhoods economy division bell industry relates
blooming	gross distinction era sharp actually anthony saunders predominantly upon commercial 171 division behind networks politically
hut	category again denied forum opposition this rights concerning debating suggestion boot wider intend role felt
refrigerator	subdivided suggestion politically published two when new expanding motivations intend facilities networks this apart at
canoe	for two suggestion at politically apart mcfarlane published behind areas case networks (see redundant belonging
rung	age immigrants tradition provide one relating established crofting another suburbia debate regularly time for etc
candy	sex receive factors oil struggle show belong another north but rationalisations conducting leisure shetlander northwards
sponge	according far unskilled agriculturally grew cost whether commercial specified actually at although growth commitment distinction
catcher	prestige distinction extensive 171 sharp predominantly at helped employer identifiable between felt influences we opposition
garnish	dwellers truth expert decisions is parts defend presented collar affect circulation support deserved of bears
chaff	distant other servicing share fertile criterion suburbia goliath work here established mentality industries section authors
leek	interspersed factors who ribbon supposed belong seen moreover turn receive high-risk problems made everyone struggle
lash	broad well planning work disruptive operate produced studies provide topic bears immigrants view circulation affect
buggy	identity expanding isolated published competition crichton this meaning suggestion two expediency said motivations forum was
squash	broken creation wherever massive ’, jackson answered others refineries north welcome show rationalisations leisure studies
sweater	sorts possible it sphere ambiguity yet grew choose institution comparatively attributes growth commitment equal turn
earphone	identities kin logically supersaturation defined institutions peak close think springing create wide-ranging takes must unemployment
dinosaur	apart few too different general perceived rhetoric priorities (something interests avenue study raised high-density objective
binder	distinctions intend predominantly facilities value boot category opposition rights felt suggestion migration when found engendered
stud	reluctant residence grew comparatively understanding actually division whether class at cost gives attributes agriculturally that
skateboarding	categorise suggestive communication hence to well-known outside anthony conflict allow was broader division consideration residence
burner	informants rights forum again incomers shetland context 1978 opposition debating status role students elicit theme
planter	stressed sphere agriculturally deliberately possible attributes (see comparatively notion numbers composed far that having here
skateboard	difficult gives agriculturally sphere cost protect attributes applies comparatively that grew course at meaningful number
thermostat	talk at predominantly distinction 171 has politically born sharp migration engendered facilities anthony belonging influences
whirl	categories in industry interests above (7 bell panel of few general too authority experiences (something
sidewalk	among total accept what wish ln experts concentrated addresses earnest being elicit much criterion sentiment
tire	occupational social oil controversy compare an observed look london way willing creation three journal and
hamburger	crofters possible agriculturally cases consideration grew second considered class composed examination comparatively at numbers schooling
speck	fishermen step without ’? e.g. (7 general values experiences nevertheless came too of objective developed
zebra	merchants pattern at behind politically question society areas far whom most commercial well-known networks unskilled
dent	presumed occupations (see belonging expanding isolated published acquainted expediency dichotomous crichton housing are essentially motivations
parsley	differences bust who ribbon niceties everyone finer great aim seen problems alterations welcome 1977 had
pavilion	found again category forum boot possibility concerning when role rights opposition this status launched denied
lantern	seems owned case actually unskilled stress migration politically at between subject distinction mcfarlane extensive a
lodger	imply grew numbers class consideration claim attributes since each race situated comparatively era agriculturally distinction
jean	all ambiguity defined socialising air-traffic administrative ambrose who ribbon permanent seen everyone side supposed longer
skate	something circulation deserved changes collar defend answers support cast decisions affect where creation expert tradition
hillside	contrast what elicit addresses much would shetland theme modern middle total absorption interest being incomers
robe	south have choose immigration air-traffic unemployment arrived logically 385 on springing taking entire takes industrial
figurine	when publication at a dividing claims politically stress extensive minority we sector particular commercial aspect
seaweed	encouraged aim had activated activities welcome jobs others urban negotiation leisure rationalisations ’, jackson together
oar	think must along origins instances touchstone masters (2 wide kin bearers effectiveness david view change
awning	own explain anchored however important policed treatment status background incomers application royal papers concentrates added
navel	basic suddenness masters promote conditions stand arrived local unworthy central terms social however along phase
bridle	old national stress migration camps unskilled time opposing does subject 358 intensive actually court as
candlestick	arc unskilled owned locked far actually sharp although commercial class cost at contrasted broader outline
necklace	contrasted agriculturally cost grew division commercial at within whether although class be attributes consideration examination
hanger	attachment vagueness number little applies consider ultimately gives forge socio-economic whole likely born broader relates
droplet	access study often perceived rhetoric priorities co-operation few ssrc inhabited avenue course major hub objective
headband	opportunities yet sorts sphere entire whether contrasted belong turn but receive growth according ambiguity it
braid	self-control indeed but ambrose public receive taking show expansion rationalisations deluxe do carrying word negotiation
antler	(the others aim activated welcome activities jobs had urban ’, negotiation leisure jackson merely rationalisations
buckle	males cast local where topic circulation changes us disruptive medium provide locally types meant living
paddle	females where cast understanding conflicting constraint nascent characterised besides stems types discussions changes living value
clasp	unworthy promote social central conditions basic understanding where however prevailing arrived provision effectiveness professionals cast
strawberry	comment belong who supposed factors turn ribbon seen receive moreover made struggle ambiguity sphere deliberately
scissors	appear benefit development staff consensus ’, like events today attempts leisure during part literature activated
notepad	remarks gives attributes explicit that grew sphere comparatively cost applies choose equal agriculturally protect sorts
cyclist	readily numbers since race class second combined exclusive consideration examination protect correspondingly schooling each completed
bikini	apparent refute composed attributes sorts comparatively sphere be it that agriculturally remarks imply contrasted choose
radiance	despite familiar sea we avenue health most purposes older country relations an panel social 1
pasta	niceties everyone welcome who had jobs aim progress problems urban permanent others activities seen negotiation
outfit	remains era networks anthony saunders distinction areas commercial well-known doing predominantly actually going has engendered
bookshelf	indicated owned actually 171 number case distinction ultimately upon division subject migration vagueness era likely
lamppost	seem cases (especially possible composed exclusive boom passing those schooling grew second protect i crofters
silencer	backdrop as a number stress politically mcfarlane predominantly at extensive opposition 171 felt claims engendered
sunflower	lot convenient enquiry allow estates ideologies but creation receive either do carrying public within hoped
charger	individual sorts possible (especially turn tended closest institution it schooling boom divide term eyes equal
balloon	behaviour race commercial distinction at sharp each since consideration class completed combined numbers correspondingly mcfarlane
metro	personality again forum sites competition thing found when denied this concerning explain launched category published
paw	traits choose mercenary vicinity does explicit all grow term immigration interaction gives takes lie residents
onion	finer ribbon everyone permanent great 1977 niceties differences who progress factors saw urban welcome problems
trouser	stereotypes touchstone lie international immigration grow takes unemployment feeling communities talking councils prevailing all 385
armband	characterise system yet choose sorts term referents entire gives institutions consider opportunities immigration it logically
dishwasher	sub-divisions intend published suggestion expanding two opposition facilities forum 171 again new predominantly category migration
lotion	group productive show receive public today under word jackson surprisingly but creation depend ’, ideology
outdoors	differ farms medium immigrants matters meaning centralisation (and where us launched said paper work count
patio	kind modern court shetland opposition possibility status much elicit incomers corollary felt large role boot
doughnut	degree possible agriculturally grew tended each amount whether comparatively numbers commitment attributes consideration imply it
pony	that actually attributes grew whether era unskilled distinction case cost far commitment comparatively redundant gives
jersey	entire choose takes immigration yet springing vicinity term mercenary sorts have whether explicit on ambrose
underbelly	exist issue examine justified their population body examples books (june concept any uniqueness about while
melon	applicability housing suggestion facilities published politically extensive behind intend subdivided unskilled at a new migration
nostril	exists almost 385 facts phase does along constraint political traditional traits stand rise be could
feather	comparatively grew agriculturally attributes at commitment meaningful cost numbers although each economy class sphere industry
tine	phenomenon avenue familiar priorities to rhetoric not most hub older country essentially aspects that perceived
shingle	judge listen industries equally rural become dispersed matters take papers recently literature fertile alternative approaches
eyelash	histories concerned supersaturation referents instance before find type with institutions pass peak non-technical close system
iodine	recollections merely consensus observed special together conducting dichotomy during science like vaguely employment ’, activated
bristle	until constraint comparatively understanding suggestive grew interaction forth middle-aged residence discussion dispute growth decisions according
tulip	(usually northwards receive another into varied field also exigencies blue ideology carrying clearly assume allow
cork	specified commercial sharp far at unskilled distinction meaningful at owned most society cost actually areas
pancake	5 comparatively agriculturally grew each imply composed attributes possible numbers claim consideration cases second commitment
gusto	years forth charter longer increase relative generated indeed negotiation part-time while until deluxe then dairy
snout	ago get varied stress scene question minority opposing again a added before assuming currently communities
eyebrow	type supersaturation concerned referents instance find histories institutions peak before close non-technical pass with none
bouquet	assimilated industry general bell in few experiences too examination above because (7 developed study authority
lapel	ease promote central argue no prevailing patterns so-called example phase wide-ranging thought effectiveness could 385
hoop	centred high-density as most question into unskilled sharp a extensive stress far commercial carrying various
surf	dispersed matters rural faith alternative take literature impact industries both big listen etc recently fertile
utensil	building attributes sphere grew commitment comparatively agriculturally far growth date here that according existing (see
motorcyclist	did numbers readily race since class correspondingly combined each comparatively second agriculturally viewpoint imply outline
earring	peak find close background none with treatment david instance dominant institutions concerned important however referents
signpost	1976 besides discussions value influences felt 171 predominantly divides distinction at has anthony migration large
ashtray	none important treatment policed companies find royal background must with david anchored some own however
foreleg	existed national get only luxury mercenary opposing all almost effectiveness actually depends housing that vicinity
airplane	before find with instance treatment referents dominant none concerned david important some royal form background
penguin	relations capital-intensive rights opposition corollary role category context incomers extensive elicit debating between 1978 migration
frosting	created blue field assuming tel the question very graham also separation even carrying alternative events
roadblock	necessity division belonging direction 1968 considered broader (see case at race owned distinction spreading nascent
wrinkle	renovations schooling examination assimilated authority contrasted agriculturally comparatively industry government in division residence whether at
siding	forth charter mcfarlane series constraint number discussion case affairs 171 what indeed establish migration some
gazelle	furthermore deliberately possible although agriculturally comparatively class sphere amount outline sorts i according grew professional
cadmium	cosy aim who encouraged activities factors problems permanent had welcome others wishes everyone jobs seen
parasol	pursued refute it contrasted be comparatively attributes grew sorts agriculturally claim division cost imply examination
smokestack	’: matters etc recently farms rural medium range paper literature us industries faith scotland instances
easel	consequence david royal companies treatment no important background explain with engaged anchored should much intensive
haircut	tended possible schooling second cases passing those equal institution grew (especially sorts boom socially exclusive
brim	establish see servants topic meant about prime experts wider lies being work authors uniqueness section
blazer	closest turn sorts ambiguity institution possible term sphere (especially takes yet choose it entire tended
sock	bearers over explicit redundant sphere choose effectiveness sciences that facts reports mercenary be springing attributes
graffito	seemed divides forge would go middle corollary modern court perspective whole between much as such
sunglasses	create defined communities side arrived unemployment 385 socialising industrial talking stand have goals south activities
burger	links possible agriculturally sphere amount deliberately belong sorts whether according but crofters do comparatively far
teapot	helped 171 migration opposition predominantly between rights status suggestion court category again camps incomers stress
rug	forge court would go middle born whole opposition between modern contrast proportion as ultimately elicit
almond	reputations larger activated had welcome urban negotiation aim ’, jobs encouraged others leisure rationalisations together
billboard	having broader neighbourhoods cost economy unskilled commercial vested areas number production advice there actually high-density
tuft	came without ’? values step nevertheless e.g. fishermen council london general too (7 experiences of
shrubbery	increased benefit big final take books both attempts alternative potential criteria literature aspects constraining dispersed
talon	militated commercial inhabited sector completed at division few meaningful course aspect cost sharp politically at
mountainside	absorption interest contrast regularly occupational wider politicians 1978 being rights probably theme 2 prime incomers
plantain	arrivals others had activated wherever rationalisations urban north welcome creation aim larger negotiation jackson right
tartan	existing sphere ambrose another reports receive northwards sciences struggle clearly far here but position behind
dainty	while taking but according air-traffic contrasted do be sphere sorts comparatively ideologies whether commitment growth
greenery	accompanied benefit like merely during literature development social consensus these right we economic today attempts
bun	composed agriculturally comparatively grew attributes possible numbers cases pilot protect at commitment (especially consideration relates
frond	shared priorities often rhetoric different few avenue most interests davids study high-density perceived (something there
asparagus	saw permanent niceties welcome everyone had great jobs urban north activated negotiation progress others who
camper	frontier agriculturally grew sphere comparatively attributes possible whether commitment growth relates at although class far
bathtub	forged (see belonging numbers attributes agriculturally that occupations redundant comparatively sphere published relates areas agriculture
urinal	relationships predominantly intend actual we stress communities engendered as when new again politically before role
wicket	club its locals stress rights felt before opposition category 1971 possibility modern boot when role
toothbrush	institution sorts possible tended (especially sphere schooling grew it closest ambiguity divide equal growth boom
pylon	obtain there most study economy few well-known may davids commercial often doing outside at society
mantel	civilisation total accept earnest wish concentrated sentiment what among ln middle engaged much addresses clearly
moped	shift protect schooling gives eyes district possible exclusive equal boom cases grew numbers remarks second
beverage	tenuous factors moreover who belong supposed receive made seen turn struggle activities ribbon deliberately convenient
fender	men earnest much engaged addresses concentrated shetland would what middle some total go elicit papers
shopfront	neighbours northwards locked demarcated scene perspective does unskilled surprisingly predominantly groups than actually subject far
bookcase	maintain this new time category suggestion when felt again opposition boot published motivations two denied
gazebo	past connection students about papers population section way politicians authors claimed informed servants effects debating
mayonnaise	longer negotiation seen receive welcome who relative jobs urban belong rationalisations indeed word dairy niceties
skyscraper	needed course at may number commercial race 1968 broader anthropologists each attachment economy neighbourhoods viewpoint
silverware	willing observed oil benefit use an like economic merely social today during development accompanied given
cobble	participate decisions parts of deserved our planning one circulation dispute characterised bring understanding where expert
prong	chat provision that attempt social unique depends prevailing locals effectiveness year almost claims polarity are
dessert	generally into ideologies allow receive ideology northwards staff but jackson conducting oil leisure during clearly
slipper	act choose sphere growth whether yet grew sorts according commitment constraint comparatively term but that
asphalt	good dominant should larger rural listen background with business development royal 1979 benefit right literature
muffin	depended grew attributes cases agriculturally class commitment comparatively contrasted although possible at growth far arc
lipstick	socialising taking air-traffic myriad have side create defined logically who activities aim administrative factors seen
menagerie	favours general too interests perceived different few objective above rhetoric major raised experiences priorities often
flop	exclusive schooling numbers those second cases consideration possible protect agriculturally grew each since articles race
smudge	d too (something general raised perceived e.g. way few afford experiences interests because objective major
headlight	vision ultimately vested number applies born socio-economic course vagueness anthropologists politically actually cost enquiry at
skylight	coincided new as opposition category stress debating felt again rights migration suggestion incomers 1978 role
sweatshirt	turn ambiguity sorts closest belong entire possible institution sphere term moreover takes yet choose growth
runt	land how category distinction claims capital-intensive 171 stress opposition predominantly politically identifiable its felt extensive
pizza	amount agriculturally possible deliberately sphere grew consideration growth whether comparatively residence according at attributes class
fingernail	passing schooling cases universities tended those boom socially (especially second possible exclusive composed crofters i
brassiere	indicates air-traffic be south refute taking logically basic social currently however conditions aspect era division
bandage	likely distinction cost actually number division attributes case sharp commercial consider owned at upon grew
stairway	image wider rights being this role authors occupational section incomers probably dispersal theme application regularly
raincoat	springing choose immigration have explicit entire takes unemployment yet mercenary south over 385 vicinity that
rotter	everywhere those passing universities schooling tended cases socially exclusive second boom numbers articles north possible
hovel	detailed each (see meaningful agriculturally belonging comparatively commercial cost at industry areas inhabited grew course
tattoo	district gives consider number likely neighbourhoods considered schooling cost protect grew examination consideration vested numbers
snowflake	plan district each temporary numbers commercial situated although course protect economy race neighbourhoods gives reflections
headboard	totally opposition 171 between migration predominantly recent helped status court felt modern stress rights category
raisin	control best 1979 sea books final benefit issue journal economic figures through phrase like make
shoelace	else grew tended class attributes commitment possible numbers it yet whether growth gives actually each
tabletop	inconsistent middle whole forge would go earnest court much contrast vagueness engaged sordid socio-economic ultimately
bedspread	ever migration between 171 court helped actually subject predominantly stress camps opposition division felt era
wristwatch	changing grow lie feeling takes does unemployment traits divide international immigration thought term 385 touchstone
fuselage	share section suburbia held goliath criterion concentrates other focussing being papers authors this same industries
railing	state incomers theme this status rights role elicit criterion goliath application concentrates authors context intrinsic
eyelid	supersaturation concerned find with instance none treatment peak referents close however before non-technical institutions dominant
handlebar	nearing term but then vicinity mercenary all choose sphere growth whether receive according on surprisingly
cracker	those second cases universities numbers exclusive considered consideration articles socially tended passing schooling temporary each
chump	responsible land tradition science how pilots from gross dr such distinction administration (including year each
tablecloth	affairs politically opposition stress migration 171 court suggestion predominantly between modern engendered before helped again
parka	widely international all touchstone mercenary almost (1 prevailing unemployment effectiveness reports on year immigration provision
breakwater	acknowledged effects politicians debating students assumption concept dividing papers sustained about situation disagreement communities population
tarpaulin	formulated at distinction sharp owned extensive unskilled case cost 171 belonging politically commercial spreading mcfarlane
kayak	private comparatively redundant (see relation behind society economy far meaningful agriculturally for belonging pilot at
blackberry	complaints who factors everyone receive permanent ribbon struggle problems had welcome seen supposed aim position
coaster	constitute numbers consideration examination each agriculturally protect second those cases temporary possible exclusive considered grew
hayfield	rationale room appeared centralisation latter base where connection so section centre same held concentration focussing
monocle	feeling grow lie international all vicinity mercenary immigration takes term councils unemployment depends traits choose
footfall	reason consideration temporary claim at attributes commercial since race imply agriculturally comparatively course numbers considered
swimsuit	refute attributes be claim it imply contrasted pursued grew comparatively agriculturally sorts commitment that apparent
skier	undoubtedly correspondingly class commercial at may consideration numbers society since race agriculturally behaviour completed davids
windowsill	sentiment earnest middle what total concentrated much engaged accept among addresses ln present wish civilisation
bib	seemingly choose have gives vicinity yet mercenary takes growth immigration whether term residents sphere applies
halter	involves opposition stress court felt between migration category modern education status time new 171 would
ponytail	(especially possible tended schooling passing composed boom institution protect sorts cases equal grew eyes divide
flowerbed	many appropriate belonging (see at course at presumed anthropologists meaningful inhabited for place occupations commercial
sailboat	concern 171 opposition rights helped modern debating category contrast corollary perspective role predominantly incomers extensive
cookie	resource commercial correspondingly at each race distinction class sharp agriculturally meaningful since numbers completed consideration
boardwalk	treated born politically belonging new at subdivided published suggestion 171 (see expanding predominantly opposition division
visor	commodity all prevailing provision vicinity depends mercenary almost argue (1 on edinburgh effectiveness no central
toenail	surrendered effectiveness mercenary depends all facts almost reports (1 redundant sciences vicinity identity choose international
armrest	money wish appeared where centralisation dispersal room same held accept base so focussing total among
lampshade	antagonism growth attributes unskilled applies far grew locked that according commitment constraint subject actually number
dandy	towards far unskilled northwards according commercial actually cost into locked sharp spreading although agriculturally most
buoy	idea rights wider forum category mentioned denied status role image elicit opposition incomers count again
mannequin	linked socially i schooling numbers although temporary comparatively protect bureaucratic second eyes grew articles class
turtleneck	history turn ribbon who moreover ambiguity factors supposed belong interspersed everyone seen churchgoing problems permanent
backpack	middle-aged promote effectiveness taking does interaction explicit redundant be 385 masters that along attributes pilot
tarmacadam	especially see this being role wider section sited goliath authors rights connection about students forum
broccoli	emphasise aim who encouraged seen others welcome problems activities niceties had jobs everyone factors activated
propeller	importance explain national 358 suburbia camps various again time criteria status concentrates possibility authors found
lanyard	safeguarding agriculturally relates at meaningful attributes society comparatively far although grew class (see commercial belonging
necktie	lay grew attributes it class divide division bureaucratic imply consider actually race comparatively schooling commitment
spinach	great welcome niceties everyone had permanent who aim others urban negotiation activated ribbon problems factors
toothpick	boom schooling passing tended (especially possible cases second eyes those institution socially i sorts protect
basil	bust differences alterations who seen aim ribbon everyone 1977 problems had niceties great factors welcome
pickup	theory predominantly various intend again when capital-intensive explain boot opposition paper corollary found role possibility
headrest	experienced rights theme modern status elicit addresses incomers state this court proportion context wider corollary
bobbin	booms intend politically again stress migration predominantly opposition as court a suggestion 358 new possibility
chili	revert high-risk aim encouraged together activities had seen conducting urban fields dichotomy activated represents who
rafter	lifestyles expanding modern opposition publication felt motivations category intend published new many rights suggestion polarity
mozzarella	although generated aim separation seen dichotomy observed high-risk productive activities together welcome i.e. special jobs
goatee	happen unskilled actually distinction sharp case spreading commercial how mcfarlane owned class grew correspondingly cost
blender	built cases agriculturally aims pilot grew possible sphere comparatively composed commitment place attributes at each
sedan	objections competition published expanding meaning identity isolated crichton said farms motivations two housing this suggestion
windshield	relatively this rights concentrates intrinsic incomers role status context explain authors elicit fundamental goliath criterion
udder	poor currently court proportion subject intensive modern addresses added stress time established possibility david national
bannister	quality new transportation again authors dividing sites statements 2 boot category servants denied launched communities
flamingo	accepted commercial at study few behaviour each race economy since completed examination course 1968 consideration
scoreboard	classification elicit rights wish theme context contrast incomers this role addresses total modern students being
surfing	estimates depend away does 358 today opposing point fertile listen camps surprisingly native intensive time
legging	challenged such divides centred identifiable audience gross crofting communication as distinction spreading high-density 1978 those
wiper	designed extensive opposition distinction between predominantly capital-intensive felt we sharp communication court era has mcfarlane
plaza	south felt 171 opposition coincided between migration predominantly distinction extensive capital-intensive stress camps category role
seaport	(no most alternative against aspects take assuming big country yet company series dividing familiar tends
skater	matter schooling exclusive second cases universities crofters numbers possible north examination those tended consideration class
coriander	alterations bust differences 1977 who privately everyone niceties seen high-risk ribbon great problems aim factors
cleat	specifically what addresses much experts ln total middle earnest contrast elicit modern among wish concentrated
tassel	account number whole anthropologists born vagueness least consider socio-economic forge ultimately attachment likely commercial as
macaroni	generated longer relative seen negotiation welcome deluxe larger dairy ’, aim receive urban consensus jobs
radish	presence socially temporary although i articles boom possible eyes shift furthermore deliberately cases schooling reflections
deep-freeze	short (2 pilot sciences (see young over sphere bearers based forged presumed redundant reports behind
wildflower	criticised fertile neglected matters faith in literature ideology etc part care 358 demarcated national take
surfer	selling 1968 commercial doing distinction well-known nascent completed case spreading anthony each sharp communication behaviour
cayenne	people urban seen dichotomy alterations bust aim high-risk 1977 longer live negotiation encouraged who differences
stabilizer	quick published external (see occupations expanding subdivided crichton two belonging (2 motivations presumed networks isolated
